"","soc_code","soc_lmi_title","employment","projected_2030","change_employment","percent_change","annual_openings_growth","exits","transfers","total_openings","median_wage","median_wage_symbol","jobsohioregion"
"1","00-0000","Total, All Occupations","1996374",2056711,60337,0.0302,6034,86886,132740,225660,"18.760000000000002",NA,"Northeast"
"2","11-0000","Management Occupations","115028",122259,7231,0.0629,723,3524,6102,10349,"47.31",NA,"Northeast"
"3","11-1011","Chief Executives","2419",2171,-248,-0.1025,-25,63,93,131,"93.02",NA,"Northeast"
"4","11-1021","General and Operations Managers","24789",26045,1256,0.0507,126,508,1576,2210,"45.59",NA,"Northeast"
"5","11-1031","Legislators","1159",1189,30,0.0259,3,27,58,88,"36940","**","Northeast"
"6","11-2021","Marketing Managers","2174",2306,132,0.0607,13,45,141,199,"61.39",NA,"Northeast"
"7","11-2022","Sales Managers","4314",4488,174,0.0403,17,88,277,382,"60.47",NA,"Northeast"
"8","11-2030","Public Relations and Fundraising Managers","754",816,62,0.0822,6,20,44,70,"57.62","^","Northeast"
"9","11-3010","Administrative Services and Facilities Managers","3776",3959,183,0.0485,18,110,193,321,"47.73","^","Northeast"
"10","11-3021","Computer and Information Systems Managers","4267",4602,335,0.0785,34,72,252,358,"62.5",NA,"Northeast"
"11","11-3031","Financial Managers","8146",9305,1159,0.1423,116,179,438,733,"60.69",NA,"Northeast"
"12","11-3051","Industrial Production Managers","4631",4771,140,0.0302,14,91,222,327,"48.38",NA,"Northeast"
"13","11-3061","Purchasing Managers","808",839,31,0.0384,3,18,44,65,"57.4",NA,"Northeast"
"14","11-3071","Transportation, Storage, and Distribution Managers","2151",2309,158,0.0735,16,42,123,181,"42.85",NA,"Northeast"
"15","11-3111","Compensation and Benefits Managers","145",148,3,0.0207,0,3,8,11,"61.83",NA,"Northeast"
"16","11-3121","Human Resources Managers","1424",1522,98,0.0688,10,34,82,126,"57.75",NA,"Northeast"
"17","11-3131","Training and Development Managers","280",304,24,0.0857,2,6,19,27,"57.19",NA,"Northeast"
"18","11-9013","Farmers, Ranchers, and Other Agricultural Managers","20475",21387,912,0.0445,91,1291,727,2109,"35.119999999999997","^","Northeast"
"19","11-9021","Construction Managers","3499",3824,325,0.0929,32,75,185,292,"45.36",NA,"Northeast"
"20","11-9031","Education Administrators, Preschool and Childcare Center/Program","718",784,66,0.0919,7,19,35,61,"22.5",NA,"Northeast"
"21","11-9032","Education Administrators, Elementary and Secondary School","3727",3943,216,0.058,22,95,178,295,"97092","**","Northeast"
"22","11-9033","Education Administrators, Postsecondary","1185",1221,36,0.0304,4,30,56,90,"45.51",NA,"Northeast"
"23","11-9039","Education Administrators, All Other","310",337,27,0.0871,3,8,15,26,"30.35",NA,"Northeast"
"24","11-9041","Architectural and Engineering Managers","1893",1928,35,0.0185,4,34,97,135,"63.35",NA,"Northeast"
"25","11-9051","Food Service Managers","4103",4504,401,0.0977,40,132,344,516,"23.97",NA,"Northeast"
"26","11-9081","Lodging Managers","359",386,27,0.0752,3,14,26,43,"28.53",NA,"Northeast"
"27","11-9111","Medical and Health Services Managers","5216",6478,1262,0.2419,126,146,297,569,"47.76",NA,"Northeast"
"28","11-9121","Natural Sciences Managers","197",210,13,0.066,1,4,10,15,"49.17",NA,"Northeast"
"29","11-9131","Postmasters and Mail Superintendents","157",141,-16,-0.1019,-2,4,7,9,"39.619999999999997",NA,"Northeast"
"30","11-9141","Property, Real Estate, and Community Association Managers","4735",4676,-59,-0.0125,-6,179,178,351,"23.91",NA,"Northeast"
"31","11-9151","Social and Community Service Managers","1939",2150,211,0.1088,21,61,110,192,"30.55",NA,"Northeast"
"32","11-9171","Funeral Home Managers","198",199,1,0.0051,0,5,10,15,"36.83",NA,"Northeast"
"33","11-9198","Personal Service Managers; Entertainment & Recreation Managers, Except Gambling; and Managers, All Other","4900",5134,234,0.0478,23,116,246,385,"59.93","^^^","Northeast"
"34","13-0000","Business and Financial Operations Occupations","111102",116587,5485,0.0494,548,2987,6689,10224,"30.63",NA,"Northeast"
"35","13-1020","Buyers and Purchasing Agents","6010",5598,-412,-0.0686,-41,197,372,528,"29.85",NA,"Northeast"
"36","13-1031","Claims Adjusters, Examiners, and Investigators","4485",4218,-267,-0.0595,-27,102,226,301,"31.08",NA,"Northeast"
"37","13-1041","Compliance Officers","2870",3041,171,0.0596,17,71,157,245,"30.51",NA,"Northeast"
"38","13-1051","Cost Estimators","3032",2995,-37,-0.0122,-4,85,182,263,"30.37",NA,"Northeast"
"39","13-1071","Human Resources Specialists","9632",10477,845,0.0877,84,272,668,1024,"29.02",NA,"Northeast"
"40","13-1075","Labor Relations Specialists","1885",1725,-160,-0.0849,-16,49,120,153,"36.94",NA,"Northeast"
"41","13-1081","Logisticians","2209",2877,668,0.3024,67,53,165,285,"30.99",NA,"Northeast"
"42","13-1111","Management Analysts","8255",9046,791,0.0958,79,278,498,855,"38.25",NA,"Northeast"
"43","13-1121","Meeting, Convention, and Event Planners","1197",1314,117,0.0977,12,38,92,142,"23.24",NA,"Northeast"
"44","13-1131","Fundraisers","1736",1909,173,0.0997,17,57,116,190,"29.07",NA,"Northeast"
"45","13-1141","Compensation, Benefits, and Job Analysis Specialists","966",1049,83,0.0859,8,30,59,97,"29.82",NA,"Northeast"
"46","13-1151","Training and Development Specialists","4122",4414,292,0.0708,29,129,262,420,"24.37",NA,"Northeast"
"47","13-1161","Market Research Analysts and Marketing Specialists","9062",10539,1477,0.163,148,232,716,1096,"29.33",NA,"Northeast"
"48","13-1198","Project Management Specialists and Business Operations Specialists, All Other","17128",17714,586,0.0342,59,404,854,1317,"35.9","^^^","Northeast"
"49","13-2011","Accountants and Auditors","19043",19866,823,0.0432,82,542,1152,1776,"35.450000000000003",NA,"Northeast"
"50","13-2020","Property Appraisers and Assessors","339",340,1,0.0029,0,13,12,25,"30.46",NA,"Northeast"
"51","13-2031","Budget Analysts","341",353,12,0.0352,1,8,18,27,"37.03",NA,"Northeast"
"52","13-2041","Credit Analysts","1028",957,-71,-0.0691,-7,17,66,76,"37.14",NA,"Northeast"
"53","13-2052","Personal Financial Advisors","3852",3958,106,0.0275,11,88,192,291,"39.44",NA,"Northeast"
"54","13-2061","Financial Examiners","1389",1683,294,0.2117,29,41,71,141,"35",NA,"Northeast"
"55","13-2071","Credit Counselors","276",293,17,0.0616,2,6,16,24,"23.45",NA,"Northeast"
"56","13-2072","Loan Officers","3699",3603,-96,-0.026,-10,78,199,267,"29.96",NA,"Northeast"
"57","13-2081","Tax Examiners and Collectors, and Revenue Agents","198",194,-4,-0.0202,0,8,9,17,"27.66",NA,"Northeast"
"58","13-2082","Tax Preparers","839",845,6,0.0072,1,46,46,93,"15.53",NA,"Northeast"
"59","13-2098","Financial and Investment Analysts, Financial Risk Specialists, and Financial Specialists, All Other","4915",5112,197,0.0401,20,88,286,394,"35.21","^^^","Northeast"
"60","15-0000","Computer and Mathematical Occupations","53153",58874,5721,0.1076,572,1153,2765,4490,"38.200000000000003",NA,"Northeast"
"61","15-1211","Computer Systems Analysts","9145",9741,596,0.0652,60,184,465,709,"45.66",NA,"Northeast"
"62","15-1212","Information Security Analysts","1144",1477,333,0.2911,33,20,72,125,"47.62",NA,"Northeast"
"63","15-1231","Computer Network Support Specialists","2691",2831,140,0.052,14,52,146,212,"29.02",NA,"Northeast"
"64","15-1232","Computer User Support Specialists","6889",7371,482,0.07,48,134,377,559,"23.1",NA,"Northeast"
"65","15-1241","Computer Network Architects","1768",1790,22,0.0124,2,24,81,107,"49.57",NA,"Northeast"
"66","15-1244","Network and Computer Systems Administrators","4221",4252,31,0.0073,3,71,200,274,"38.270000000000003",NA,"Northeast"
"67","15-1245","Database Administrators and Architects","1463",1543,80,0.0547,8,35,74,117,"47.44","^^^","Northeast"
"68","15-1251","Computer Programmers","1477",1305,-172,-0.1165,-17,28,64,75,"30.22",NA,"Northeast"
"69","15-1256","Software Developers and Software Quality Assurance Analysts and Testers","16852",20011,3159,0.1875,316,427,904,1647,"49.49","^^^","Northeast"
"70","15-1257","Web Developers and Digital Interface Designers","1599",1739,140,0.0876,14,39,82,135,"49.49","^^^","Northeast"
"71","15-1299","Computer Occupations, All Other","3244",3480,236,0.0727,24,78,165,267,"42.7",NA,"Northeast"
"72","15-2031","Operations Research Analysts","1258",1557,299,0.2377,30,30,61,121,"38.25",NA,"Northeast"
"73","15-2098","Data Scientists and Mathematical Science Occupations, All Other","642",824,182,0.2835,18,15,37,70,"30.03","^^^","Northeast"
"74","17-0000","Architecture and Engineering Occupations","28796",30001,1205,0.0418,120,688,1379,2187,"37.380000000000003",NA,"Northeast"
"75","17-1011","Architects, Except Landscape and Naval","1046",1063,17,0.0163,2,29,45,76,"37.61",NA,"Northeast"
"76","17-1022","Surveyors","420",422,2,0.0048,0,14,21,35,"29.62",NA,"Northeast"
"77","17-2031","Biomedical Engineers","219",221,2,0.0091,0,5,9,14,"45.82",NA,"Northeast"
"78","17-2041","Chemical Engineers","453",495,42,0.0927,4,9,18,31,"47.76",NA,"Northeast"
"79","17-2051","Civil Engineers","2288",2428,140,0.0612,14,47,118,179,"38.520000000000003",NA,"Northeast"
"80","17-2061","Computer Hardware Engineers","256",258,2,0.0078,0,5,12,17,"47.6",NA,"Northeast"
"81","17-2071","Electrical Engineers","2301",2418,117,0.0508,12,56,94,162,"45.82",NA,"Northeast"
"82","17-2072","Electronics Engineers, Except Computer","681",694,13,0.0191,1,16,28,45,"45.84",NA,"Northeast"
"83","17-2081","Environmental Engineers","298",305,7,0.0235,1,7,15,23,"58.66",NA,"Northeast"
"84","17-2111","Health and Safety Engineers, Except Mining Safety Engineers and Inspectors","181",195,14,0.0773,1,4,8,13,"46.68",NA,"Northeast"
"85","17-2112","Industrial Engineers","4348",4803,455,0.1046,46,100,183,329,"38.43",NA,"Northeast"
"86","17-2131","Materials Engineers","900",952,52,0.0578,5,19,36,60,"38.380000000000003",NA,"Northeast"
"87","17-2141","Mechanical Engineers","4838",5136,298,0.0616,30,86,205,321,"37.65",NA,"Northeast"
"88","17-2199","Engineers, All Other","1998",2044,46,0.023,5,43,83,131,"45.82",NA,"Northeast"
"89","17-3011","Architectural and Civil Drafters","858",850,-8,-0.0093,-1,26,54,79,"24.28",NA,"Northeast"
"90","17-3013","Mechanical Drafters","875",821,-54,-0.0617,-5,26,54,75,"28.69",NA,"Northeast"
"91","17-3022","Civil Engineering Technicians","493",485,-8,-0.0162,-1,15,30,44,"29.19",NA,"Northeast"
"92","17-3023","Electrical and Electronics Engineering Technicians","821",793,-28,-0.0341,-3,24,50,71,"30.94",NA,"Northeast"
"93","17-3025","Environmental Engineering Technicians","193",199,6,0.0311,1,6,12,19,"23.49",NA,"Northeast"
"94","17-3026","Industrial Engineering Technicians","1001",1024,23,0.023,2,30,62,94,"23.45",NA,"Northeast"
"95","17-3027","Mechanical Engineering Technicians","838",865,27,0.0322,3,26,52,81,"28.42",NA,"Northeast"
"96","17-3031","Surveying and Mapping Technicians","334",332,-2,-0.006,0,12,29,41,"22.78",NA,"Northeast"
"97","17-3098","Calibration and Engineering Technologists and Technicians, Except Drafters, All Other","902",921,19,0.0211,2,27,56,85,"29.18","^^^","Northeast"
"98","19-0000","Life, Physical, and Social Science Occupations","13938",14849,911,0.0654,91,303,998,1392,"30.9",NA,"Northeast"
"99","19-1012","Food Scientists and Technologists","442",465,23,0.052,2,10,38,50,"45.22",NA,"Northeast"
"100","19-1023","Zoologists and Wildlife Biologists","107",117,10,0.0935,1,2,8,11,"30.65",NA,"Northeast"
"101","19-1031","Conservation Scientists","319",329,10,0.0313,1,6,23,30,"22.87",NA,"Northeast"
"102","19-1042","Medical Scientists, Except Epidemiologists","1724",1970,246,0.1427,25,24,106,155,"38.229999999999997",NA,"Northeast"
"103","19-2031","Chemists","1223",1294,71,0.0581,7,18,94,119,"37.24",NA,"Northeast"
"104","19-2032","Materials Scientists","109",113,4,0.0367,0,2,8,10,"45.57",NA,"Northeast"
"105","19-2041","Environmental Scientists and Specialists, Including Health","567",598,31,0.0547,3,10,46,59,"30.89",NA,"Northeast"
"106","19-3031","Clinical, Counseling, and School Psychologists","1641",1758,117,0.0713,12,44,66,122,"38.96","^^^","Northeast"
"107","19-3039","Psychologists, All Other","432",431,-1,-0.0023,0,11,17,28,"50.77",NA,"Northeast"
"108","19-3051","Urban and Regional Planners","314",323,9,0.0287,1,5,22,28,"31.2",NA,"Northeast"
"109","19-3099","Social Scientists and Related Workers, All Other","204",219,15,0.0735,2,5,14,21,"38.86",NA,"Northeast"
"110","19-4021","Biological Technicians","1545",1688,143,0.0926,14,38,162,214,"23.84",NA,"Northeast"
"111","19-4031","Chemical Technicians","997",1018,21,0.0211,2,18,91,111,"23.54",NA,"Northeast"
"112","19-4042","Environmental Science and Protection Technicians, Including Health","407",441,34,0.0835,3,11,40,54,"22.91",NA,"Northeast"
"113","19-4061","Social Science Research Assistants","187",197,10,0.0535,1,5,18,24,"27.82",NA,"Northeast"
"114","19-4092","Forensic Science Technicians","178",197,19,0.1067,2,5,18,25,"29.89",NA,"Northeast"
"115","19-4099","Life, Physical, and Social Science Technicians, All Other","452",477,25,0.0553,2,12,44,58,"23.46",NA,"Northeast"
"116","19-5011","Occupational Health and Safety Specialists","1397",1441,44,0.0315,4,39,61,104,"37.39",NA,"Northeast"
"117","19-5012","Occupational Health and Safety Technicians","232",244,12,0.0517,1,6,10,17,"23.39",NA,"Northeast"
"118","21-0000","Community and Social Service Occupations","36513",39934,3421,0.0937,342,1297,2458,4097,"22.9",NA,"Northeast"
"119","21-1012","Educational, Guidance, School, and Vocational Counselors","4060",4404,344,0.0847,34,138,251,423,"29.24",NA,"Northeast"
"120","21-1013","Marriage and Family Therapists","103",110,7,0.068,1,4,6,11,"24.93",NA,"Northeast"
"121","21-1015","Rehabilitation Counselors","1574",1782,208,0.1321,21,55,99,175,"18.510000000000002",NA,"Northeast"
"122","21-1018","Substance Abuse, Behavioral Disorder, and Mental Health Counselors","3473",4031,558,0.1607,56,122,222,400,"22.62",NA,"Northeast"
"123","21-1021","Child, Family, and School Social Workers","4775",5194,419,0.0877,42,140,315,497,"22.95",NA,"Northeast"
"124","21-1022","Healthcare Social Workers","2353",2475,122,0.0518,12,68,152,232,"29.03",NA,"Northeast"
"125","21-1023","Mental Health and Substance Abuse Social Workers","2547",2884,337,0.1323,34,76,172,282,"22.18",NA,"Northeast"
"126","21-1029","Social Workers, All Other","1508",1612,104,0.069,10,44,99,153,"26.76",NA,"Northeast"
"127","21-1091","Health Educators","964",998,34,0.0353,3,33,68,104,"29.19",NA,"Northeast"
"128","21-1092","Probation Officers and Correctional Treatment Specialists","947",952,5,0.0053,0,21,57,78,"24.03",NA,"Northeast"
"129","21-1093","Social and Human Service Assistants","6700",7390,690,0.103,69,281,532,882,"17.690000000000001",NA,"Northeast"
"130","21-1094","Community Health Workers","746",853,107,0.1434,11,27,55,93,"18.440000000000001",NA,"Northeast"
"131","21-1099","Community and Social Service Specialists, All Other","697",758,61,0.0875,6,25,50,81,"22.97",NA,"Northeast"
"132","21-2011","Clergy","4606",4931,325,0.0706,32,196,275,503,"23.73",NA,"Northeast"
"133","23-0000","Legal Occupations","16215",17332,1117,0.0689,112,474,687,1273,"36.21",NA,"Northeast"
"134","23-1011","Lawyers","8469",9097,628,0.0742,63,190,216,469,"49.3",NA,"Northeast"
"135","23-1012","Judicial Law Clerks","113",114,1,0.0088,0,4,4,8,"23.5",NA,"Northeast"
"136","23-1021","Administrative Law Judges, Adjudicators, and Hearing Officers","208",209,1,0.0048,0,4,5,9,"55.39",NA,"Northeast"
"137","23-1022","Arbitrators, Mediators, and Conciliators","145",157,12,0.0828,1,3,4,8,"31.43",NA,"Northeast"
"138","23-1023","Judges, Magistrate Judges, and Magistrates","895",899,4,0.0045,0,19,22,41,"47.93",NA,"Northeast"
"139","23-2011","Paralegals and Legal Assistants","5094",5590,496,0.0974,50,207,361,618,"22.65",NA,"Northeast"
"140","23-2093","Title Examiners, Abstractors, and Searchers","868",850,-18,-0.0207,-2,31,50,79,"23.52",NA,"Northeast"
"141","25-0000","Education, Training, and Library Occupations","102995",109952,6957,0.0675,696,4109,4756,9561,"29.24",NA,"Northeast"
"142","25-1011","Business Teachers, Postsecondary","924",954,30,0.0325,3,42,44,89,"72829","**","Northeast"
"143","25-1021","Computer Science Teachers, Postsecondary","278",286,8,0.0288,1,13,13,27,"79927","**","Northeast"
"144","25-1022","Mathematical Science Teachers, Postsecondary","495",513,18,0.0364,2,22,24,48,"76191","**","Northeast"
"145","25-1042","Biological Science Teachers, Postsecondary","444",486,42,0.0946,4,21,22,47,"64388","**","Northeast"
"146","25-1052","Chemistry Teachers, Postsecondary","244",254,10,0.041,1,11,12,24,"77449","**","Northeast"
"147","25-1054","Physics Teachers, Postsecondary","156",162,6,0.0385,1,7,7,15,"76584","**","Northeast"
"148","25-1063","Economics Teachers, Postsecondary","182",191,9,0.0495,1,8,9,18,"76751","**","Northeast"
"149","25-1065","Political Science Teachers, Postsecondary","143",151,8,0.0559,1,7,7,15,"77629","**","Northeast"
"150","25-1066","Psychology Teachers, Postsecondary","415",444,29,0.0699,3,19,20,42,"77629","**","Northeast"
"151","25-1067","Sociology Teachers, Postsecondary","160",167,7,0.0438,1,7,8,16,"77629","**","Northeast"
"152","25-1071","Health Specialties Teachers, Postsecondary","908",1068,160,0.1762,16,44,46,106,"158455","**","Northeast"
"153","25-1072","Nursing Instructors and Teachers, Postsecondary","1028",1221,193,0.1877,19,50,52,121,"74354","**","Northeast"
"154","25-1081","Education Teachers, Postsecondary","730",763,33,0.0452,3,33,35,71,"61380","**","Northeast"
"155","25-1111","Criminal Justice and Law Enforcement Teachers, Postsecondary","268",291,23,0.0858,2,12,13,27,"61221","**","Northeast"
"156","25-1113","Social Work Teachers, Postsecondary","174",181,7,0.0402,1,8,8,17,"77629","**","Northeast"
"157","25-1121","Art, Drama, and Music Teachers, Postsecondary","1453",1580,127,0.0874,13,68,71,152,"63200","**","Northeast"
"158","25-1122","Communications Teachers, Postsecondary","335",350,15,0.0448,2,15,16,33,"64266","**","Northeast"
"159","25-1123","English Language and Literature Teachers, Postsecondary","685",711,26,0.038,3,31,33,67,"62072","**","Northeast"
"160","25-1124","Foreign Language and Literature Teachers, Postsecondary","332",346,14,0.0422,1,15,16,32,"63742","**","Northeast"
"161","25-1125","History Teachers, Postsecondary","227",238,11,0.0485,1,10,11,22,"77629","**","Northeast"
"162","25-1193","Recreation and Fitness Studies Teachers, Postsecondary","189",195,6,0.0317,1,9,9,19,"61380","**","Northeast"
"163","25-1194","Vocational Education Teachers, Postsecondary","1001",1044,43,0.043,4,46,48,98,"23.97",NA,"Northeast"
"164","25-1199","Postsecondary Teachers, All Other","1679",1667,-12,-0.0071,-1,75,78,152,"64645","**","Northeast"
"165","25-2011","Preschool Teachers, Except Special Education","4555",5395,840,0.1844,84,204,290,578,"13.86",NA,"Northeast"
"166","25-2012","Kindergarten Teachers, Except Special Education","892",948,56,0.0628,6,38,54,98,"60747","**","Northeast"
"167","25-2021","Elementary School Teachers, Except Special Education","19306",20255,949,0.0492,95,607,793,1495,"72279","**","Northeast"
"168","25-2022","Middle School Teachers, Except Special and Career/Technical Education","11176",11735,559,0.05,56,352,459,867,"75328","**","Northeast"
"169","25-2031","Secondary School Teachers, Except Special and Career/Technical Education","15709",16579,870,0.0554,87,428,655,1170,"76047","**","Northeast"
"170","25-2052","Special Education Teachers, Kindergarten and Elementary School","1973",2085,112,0.0568,11,66,81,158,"71956","**","Northeast"
"171","25-2057","Special Education Teachers, Middle School","1153",1210,57,0.0494,6,38,47,91,"62423","**","Northeast"
"172","25-2058","Special Education Teachers, Secondary School","2531",2686,155,0.0612,16,85,104,205,"62073","**","Northeast"
"173","25-2059","Special Education Teachers, All Other","245",279,34,0.1388,3,8,10,21,"48718","**","Northeast"
"174","25-3011","Adult Basic and Secondary Education and Literacy Teachers and Instructors","436",400,-36,-0.0826,-4,25,22,43,"24.1",NA,"Northeast"
"175","25-3021","Self-Enrichment Education Teachers","3511",4197,686,0.1954,69,230,206,505,"14.95",NA,"Northeast"
"176","25-3031","Substitute Teachers, Short-Term","1830",2003,173,0.0945,17,114,103,234,"14.01",NA,"Northeast"
"177","25-3097","Teachers and Instructors, All Other, Except Substitute Teachers","3424",3777,353,0.1031,35,215,193,443,"17.940000000000001","^^^","Northeast"
"178","25-4022","Librarians and Media Collections Specialists","1879",1959,80,0.0426,8,94,84,186,"23.98",NA,"Northeast"
"179","25-4031","Library Technicians","1236",1158,-78,-0.0631,-8,99,74,165,"17.47",NA,"Northeast"
"180","25-9031","Instructional Coordinators","1550",1648,98,0.0632,10,79,70,159,"30.61",NA,"Northeast"
"181","25-9045","Teaching Assistants, Except Postsecondary","14453",15427,974,0.0674,97,668,698,1463,"28929","**","Northeast"
"182","27-0000","Arts, Design, Entertainment, Sports, and Media Occupations","26003",27169,1166,0.0448,117,1046,1710,2873,"22.75",NA,"Northeast"
"183","27-1011","Art Directors","601",627,26,0.0433,3,30,32,65,"37.909999999999997",NA,"Northeast"
"184","27-1012","Craft Artists","126",108,-18,-0.1429,-2,6,6,10,"18.329999999999998",NA,"Northeast"
"185","27-1013","Fine Artists, Including Painters, Sculptors, and Illustrators","173",196,23,0.1329,2,9,10,21,"19.190000000000001",NA,"Northeast"
"186","27-1014","Multimedia Artists and Animators","137",140,3,0.0219,0,7,7,14,"28.7",NA,"Northeast"
"187","27-1021","Commercial and Industrial Designers","488",505,17,0.0348,2,15,30,47,"30.86",NA,"Northeast"
"188","27-1023","Floral Designers","628",482,-146,-0.2325,-15,17,33,35,"13.63",NA,"Northeast"
"189","27-1024","Graphic Designers","3361",3169,-192,-0.0571,-19,100,194,275,"23.51",NA,"Northeast"
"190","27-1025","Interior Designers","1033",1013,-20,-0.0194,-2,31,61,90,"23.64",NA,"Northeast"
"191","27-1026","Merchandise Displayers and Window Trimmers","1730",1716,-14,-0.0081,-1,53,102,154,"14.52",NA,"Northeast"
"192","27-1027","Set and Exhibit Designers","141",133,-8,-0.0567,-1,4,8,11,"25.2",NA,"Northeast"
"193","27-1029","Designers, All Other","124",118,-6,-0.0484,-1,4,7,10,"18.86",NA,"Northeast"
"194","27-2012","Producers and Directors","570",609,39,0.0684,4,13,37,54,"29.46",NA,"Northeast"
"195","27-2022","Coaches and Scouts","4734",5210,476,0.1005,48,282,400,730,"36962","**","Northeast"
"196","27-2041","Music Directors and Composers","578",619,41,0.0709,4,35,34,73,"24.06",NA,"Northeast"
"197","27-2042","Musicians and Singers","1565",1716,151,0.0965,15,96,92,203,"39.14",NA,"Northeast"
"198","27-2090","Miscellaneous Entertainers and Performers, Sports and Related Workers","222",295,73,0.3288,7,10,14,31,"17.59","^","Northeast"
"199","27-3011","Radio and Television Announcers","327",322,-5,-0.0153,0,13,18,31,"14.4",NA,"Northeast"
"200","27-3023","News Analysts, Reporters, and Journalists","659",651,-8,-0.0121,-1,19,50,68,"18.559999999999999",NA,"Northeast"
"201","27-3031","Public Relations Specialists","2300",2431,131,0.057,13,59,155,227,"29.79",NA,"Northeast"
"202","27-3041","Editors","728",701,-27,-0.0371,-3,23,45,65,"29.24",NA,"Northeast"
"203","27-3042","Technical Writers","391",425,34,0.087,3,11,25,39,"30.3",NA,"Northeast"
"204","27-3043","Writers and Authors","1070",1072,2,0.0019,0,43,59,102,"22.71",NA,"Northeast"
"205","27-3091","Interpreters and Translators","746",899,153,0.2051,15,32,45,92,"23.35",NA,"Northeast"
"206","27-4011","Audio and Video Equipment Technicians","606",715,109,0.1799,11,17,48,76,"21.68",NA,"Northeast"
"207","27-4012","Broadcast Technicians","250",253,3,0.012,0,7,18,25,"23.36",NA,"Northeast"
"208","27-4014","Sound Engineering Technicians","118",120,2,0.0169,0,3,9,12,"22.7",NA,"Northeast"
"209","27-4021","Photographers","1095",1215,120,0.1096,12,39,65,116,"18.21",NA,"Northeast"
"210","27-4098","Lighting Technicians and Media and Communication Equipment Workers, All Other","106",119,13,0.1226,1,3,8,12,"23.52","^^^","Northeast"
"211","29-0000","Healthcare Practitioners and Technical Occupations","142977",150554,7577,0.053,758,3744,4444,8946,"30.43",NA,"Northeast"
"212","29-1011","Chiropractors","820",822,2,0.0024,0,12,7,19,"29.11",NA,"Northeast"
"213","29-1021","Dentists, General","1399",1374,-25,-0.0179,-2,26,12,36,"78.92",NA,"Northeast"
"214","29-1031","Dietitians and Nutritionists","961",1004,43,0.0447,4,32,34,70,"29.4",NA,"Northeast"
"215","29-1041","Optometrists","435",433,-2,-0.0046,0,8,5,13,"48.7",NA,"Northeast"
"216","29-1051","Pharmacists","5148",4979,-169,-0.0328,-17,93,97,173,"61.72",NA,"Northeast"
"217","29-1071","Physician Assistants","2417",3065,648,0.2681,65,43,108,216,"49.67",NA,"Northeast"
"218","29-1081","Podiatrists","172",161,-11,-0.064,-1,4,7,10,"62.09",NA,"Northeast"
"219","29-1122","Occupational Therapists","2592",2877,285,0.11,28,59,89,176,"38.99",NA,"Northeast"
"220","29-1123","Physical Therapists","3815",4256,441,0.1156,44,80,84,208,"45.93",NA,"Northeast"
"221","29-1124","Radiation Therapists","226",238,12,0.0531,1,4,7,12,"38.4",NA,"Northeast"
"222","29-1125","Recreational Therapists","291",289,-2,-0.0069,0,9,13,22,"22.81",NA,"Northeast"
"223","29-1126","Respiratory Therapists","2645",3172,527,0.1992,53,62,73,188,"29.78",NA,"Northeast"
"224","29-1127","Speech-Language Pathologists","2362",2868,506,0.2142,51,61,94,206,"38.340000000000003",NA,"Northeast"
"225","29-1128","Exercise Physiologists","191",206,15,0.0785,2,6,7,15,"28.55",NA,"Northeast"
"226","29-1129","Therapists, All Other","151",164,13,0.0861,1,5,5,11,"28.42",NA,"Northeast"
"227","29-1131","Veterinarians","834",957,123,0.1475,12,14,14,40,"47.52",NA,"Northeast"
"228","29-1141","Registered Nurses","47492",49684,2192,0.0462,219,1296,1222,2737,"35.75",NA,"Northeast"
"229","29-1151","Nurse Anesthetists","1246",1275,29,0.0233,3,25,38,66,"81.260000000000005",NA,"Northeast"
"230","29-1171","Nurse Practitioners","3348",4685,1337,0.3993,134,84,126,344,"50.68",NA,"Northeast"
"231","29-1181","Audiologists","205",222,17,0.0829,2,5,4,11,"29.24",NA,"Northeast"
"232","29-1211","Anesthesiologists","428",403,-25,-0.0584,-2,7,5,10,"#",NA,"Northeast"
"233","29-1215","Family Medicine Physicians","612",597,-15,-0.0245,-2,10,7,15,"67.7",NA,"Northeast"
"234","29-1216","General Internal Medicine Physicians","817",722,-95,-0.1163,-10,12,9,11,"#",NA,"Northeast"
"235","29-1218","Obstetricians and Gynecologists","304",280,-24,-0.0789,-2,5,3,6,"#",NA,"Northeast"
"236","29-1292","Dental Hygienists","3536",3580,44,0.0124,4,128,89,221,"36.840000000000003",NA,"Northeast"
"237","29-1298","Acupuncturists and Healthcare Diagnosing or Treating Practitioners, All Other","340",355,15,0.0441,2,15,5,22,"37.450000000000003","^^^","Northeast"
"238","29-2010","Clinical Laboratory Technologists and Technicians","4351",4594,243,0.0558,24,115,166,305,"28.2",NA,"Northeast"
"239","29-2031","Cardiovascular Technologists and Technicians","822",873,51,0.062,5,23,36,64,"29.5",NA,"Northeast"
"240","29-2032","Diagnostic Medical Sonographers","1262",1438,176,0.1395,18,37,58,113,"36.06",NA,"Northeast"
"241","29-2033","Nuclear Medicine Technologists","348",368,20,0.0575,2,10,15,27,"37.479999999999997",NA,"Northeast"
"242","29-2034","Radiologic Technologists","3510",3667,157,0.0447,16,98,154,268,"29.12",NA,"Northeast"
"243","29-2035","Magnetic Resonance Imaging Technologists","594",616,22,0.037,2,16,26,44,"36.06",NA,"Northeast"
"244","29-2040","Emergency Medical Technicians and Paramedics","3663",3652,-11,-0.003,-1,68,169,236,"17.760000000000002","^","Northeast"
"245","29-2051","Dietetic Technicians","363",378,15,0.0413,2,10,16,28,"14.54",NA,"Northeast"
"246","29-2052","Pharmacy Technicians","6376",6516,140,0.022,14,176,277,467,"16.54",NA,"Northeast"
"247","29-2053","Psychiatric Technicians","448",522,74,0.1652,7,13,21,41,"17.22",NA,"Northeast"
"248","29-2055","Surgical Technologists","1433",1503,70,0.0488,7,40,63,110,"23.21",NA,"Northeast"
"249","29-2056","Veterinary Technologists and Technicians","1391",1579,188,0.1352,19,40,64,123,"17.57",NA,"Northeast"
"250","29-2057","Ophthalmic Medical Technicians","855",870,15,0.0175,2,24,37,63,"17.850000000000001",NA,"Northeast"
"251","29-2061","Licensed Practical and Licensed Vocational Nurses","15538",15622,84,0.0054,8,525,650,1183,"22.81",NA,"Northeast"
"252","29-2081","Opticians, Dispensing","1308",1347,39,0.0298,4,55,45,104,"21.96",NA,"Northeast"
"253","29-2091","Orthotists and Prosthetists","510",562,52,0.102,5,15,23,43,"28.26",NA,"Northeast"
"254","29-2098","Medical Dosimetrists, Medical Records Specialists, and Health Technologists and Technicians, All Other","6355",6582,227,0.0357,23,176,278,477,"22.55","^^^","Northeast"
"255","29-9098","Health Information Technologists, Medical Registrars, Surgical Assistants, & Healthcare Practitioners, AO","845",901,56,0.0663,6,24,38,68,"26.19","^^^","Northeast"
"256","31-0000","Healthcare Support Occupations","86899",96033,9134,0.1051,913,5361,5645,11919,"14.12",NA,"Northeast"
"257","31-1120","Home Health and Personal Care Aides","35237",41945,6708,0.1904,671,2471,2185,5327,"11.49",NA,"Northeast"
"258","31-1131","Nursing Assistants","25222",25036,-186,-0.0074,-19,1609,1423,3013,"14.38",NA,"Northeast"
"259","31-1132","Orderlies","998",1056,58,0.0581,6,66,58,130,"14.25",NA,"Northeast"
"260","31-2011","Occupational Therapy Assistants","2036",2611,575,0.2824,58,116,170,344,"29.51",NA,"Northeast"
"261","31-2021","Physical Therapist Assistants","2410",2915,505,0.2095,50,114,201,365,"29.6",NA,"Northeast"
"262","31-2022","Physical Therapist Aides","404",451,47,0.1163,5,18,32,55,"14.31",NA,"Northeast"
"263","31-9011","Massage Therapists","1127",1264,137,0.1216,14,70,62,146,"22.55",NA,"Northeast"
"264","31-9091","Dental Assistants","3512",3548,36,0.0103,4,161,248,413,"18.170000000000002",NA,"Northeast"
"265","31-9092","Medical Assistants","9461",10269,808,0.0854,81,405,737,1223,"17.579999999999998",NA,"Northeast"
"266","31-9093","Medical Equipment Preparers","843",884,41,0.0486,4,48,57,109,"18.07",NA,"Northeast"
"267","31-9094","Medical Transcriptionists","200",149,-51,-0.255,-5,9,15,19,"11.21",NA,"Northeast"
"268","31-9095","Pharmacy Aides","341",275,-66,-0.1935,-7,16,24,33,"14.17",NA,"Northeast"
"269","31-9096","Veterinary Assistants and Laboratory Animal Caretakers","1344",1525,181,0.1347,18,70,158,246,"14.24",NA,"Northeast"
"270","31-9097","Phlebotomists","2433",2691,258,0.106,26,110,186,322,"17.649999999999999",NA,"Northeast"
"271","31-9099","Healthcare Support Workers, All Other","925",970,45,0.0486,4,52,62,118,"17.8",NA,"Northeast"
"272","33-0000","Protective Service Occupations","41920",41929,9,2e-04,1,2050,2657,4708,"22.81",NA,"Northeast"
"273","33-1011","First-Line Supervisors of Correctional Officers","222",216,-6,-0.027,-1,7,10,16,"31.74",NA,"Northeast"
"274","33-1012","First-Line Supervisors of Police and Detectives","1020",1042,22,0.0216,2,23,42,67,"40.61",NA,"Northeast"
"275","33-1021","First-Line Supervisors of Fire Fighting and Prevention Workers","672",692,20,0.0298,2,16,28,46,"37.43",NA,"Northeast"
"276","33-1090","Miscellaneous First-Line Supervisors, Protective Service Workers","676",669,-7,-0.0104,-1,25,39,63,"25.23","^","Northeast"
"277","33-2011","Firefighters","6657",6897,240,0.0361,24,149,350,523,"24.13",NA,"Northeast"
"278","33-3011","Bailiffs","519",506,-13,-0.025,-1,19,28,46,"22.43",NA,"Northeast"
"279","33-3012","Correctional Officers and Jailers","5268",4716,-552,-0.1048,-55,188,270,403,"23.04",NA,"Northeast"
"280","33-3021","Detectives and Criminal Investigators","691",697,6,0.0087,1,18,32,51,"37.299999999999997",NA,"Northeast"
"281","33-3051","Police and Sheriff's Patrol Officers","9017",9215,198,0.022,20,228,463,711,"30.75",NA,"Northeast"
"282","33-9011","Animal Control Workers","188",204,16,0.0851,2,6,10,18,"18.829999999999998",NA,"Northeast"
"283","33-9032","Security Guards","10362",9866,-496,-0.0479,-50,536,783,1269,"14.02",NA,"Northeast"
"284","33-9091","Crossing Guards","1513",1699,186,0.1229,19,234,83,336,"14.2",NA,"Northeast"
"285","33-9092","Lifeguards, Ski Patrol, and Other Recreational Protective Service Workers","1815",2091,276,0.1521,28,269,217,514,"10.82",NA,"Northeast"
"286","33-9098","School Bus Monitors and Protective Service Workers, All Other","2053",2165,112,0.0546,11,290,234,535,"15.11","^^^","Northeast"
"287","35-0000","Food Preparation and Serving Related Occupations","155933",174594,18661,0.1197,1866,12707,16862,31435,"10.96",NA,"Northeast"
"288","35-1011","Chefs and Head Cooks","1031",1186,155,0.1503,16,33,109,158,"24.91",NA,"Northeast"
"289","35-1012","First-Line Supervisors of Food Preparation and Serving Workers","13050",15078,2028,0.1554,203,628,1433,2264,"15.94",NA,"Northeast"
"290","35-2011","Cooks, Fast Food","6616",6157,-459,-0.0694,-46,376,547,877,"10.64",NA,"Northeast"
"291","35-2012","Cooks, Institution and Cafeteria","8249",8299,50,0.0061,5,487,708,1200,"14.38",NA,"Northeast"
"292","35-2014","Cooks, Restaurant","12672",17862,5190,0.4096,519,898,1307,2724,"13.85",NA,"Northeast"
"293","35-2015","Cooks, Short Order","1303",1350,47,0.0361,5,78,114,197,"12.33",NA,"Northeast"
"294","35-2021","Food Preparation Workers","6722",6882,160,0.0238,16,534,626,1176,"11.64",NA,"Northeast"
"295","35-3011","Bartenders","7121",8635,1514,0.2126,151,357,955,1463,"10.220000000000001",NA,"Northeast"
"296","35-3023","Fast Food and Counter Workers","57888",62958,5070,0.0876,507,5859,6388,12754,"10.71",NA,"Northeast"
"297","35-3031","Waiters and Waitresses","24442",27563,3121,0.1277,312,1909,3105,5326,"9.86",NA,"Northeast"
"298","35-3041","Food Servers, Nonrestaurant","5234",5331,97,0.0185,10,418,412,840,"12.12",NA,"Northeast"
"299","35-9011","Dining Room and Cafeteria Attendants and Bartender Helpers","2763",3315,552,0.1998,55,262,263,580,"11.52",NA,"Northeast"
"300","35-9021","Dishwashers","4734",5257,523,0.1105,52,376,418,846,"10.86",NA,"Northeast"
"301","35-9031","Hosts and Hostesses, Restaurant, Lounge, and Coffee Shop","3440",4077,637,0.1852,64,445,423,932,"10.6",NA,"Northeast"
"302","35-9099","Food Preparation and Serving Related Workers, All Other","287",325,38,0.1324,4,26,26,56,"10.98",NA,"Northeast"
"303","37-0000","Building and Grounds Cleaning and Maintenance Occupations","63680",64348,668,0.0105,67,3600,4714,8381,"14.29",NA,"Northeast"
"304","37-1011","First-Line Supervisors of Housekeeping and Janitorial Workers","2113",2091,-22,-0.0104,-2,90,145,233,"21.82",NA,"Northeast"
"305","37-1012","First-Line Supervisors of Landscaping, Lawn Service, and Groundskeeping Workers","1909",1863,-46,-0.0241,-5,58,135,188,"23",NA,"Northeast"
"306","37-2011","Janitors and Cleaners, Except Maids and Housekeeping Cleaners","29414",29935,521,0.0177,52,1852,2080,3984,"14.05",NA,"Northeast"
"307","37-2012","Maids and Housekeeping Cleaners","11922",11945,23,0.0019,2,811,768,1581,"11.86",NA,"Northeast"
"308","37-3011","Landscaping and Groundskeeping Workers","16957",17135,178,0.0105,18,733,1462,2213,"14.55",NA,"Northeast"
"309","39-0000","Personal Care and Service Occupations","48831",51980,3149,0.0645,315,3137,3855,7307,"12.01",NA,"Northeast"
"310","39-2021","Nonfarm Animal Caretakers","3613",4472,859,0.2378,86,259,336,681,"11.14",NA,"Northeast"
"311","39-3031","Ushers, Lobby Attendants, and Ticket Takers","1090",1389,299,0.2743,30,157,126,313,"10.8",NA,"Northeast"
"312","39-3091","Amusement and Recreation Attendants","3714",4301,587,0.1581,59,391,449,899,"10.29",NA,"Northeast"
"313","39-3093","Locker Room, Coatroom, and Dressing Room Attendants","125",148,23,0.184,2,13,15,30,"11.49",NA,"Northeast"
"314","39-4021","Funeral Attendants","968",965,-3,-0.0031,0,55,73,128,"14",NA,"Northeast"
"315","39-5012","Hairdressers, Hairstylists, and Cosmetologists","12751",12175,-576,-0.0452,-58,660,692,1294,"13.67",NA,"Northeast"
"316","39-5092","Manicurists and Pedicurists","1590",1620,30,0.0189,3,82,85,170,"10.98",NA,"Northeast"
"317","39-6012","Concierges","436",442,6,0.0138,1,23,34,58,"14.55",NA,"Northeast"
"318","39-7010","Tour and Travel Guides","285",375,90,0.3158,9,21,31,61,"13.7",NA,"Northeast"
"319","39-9011","Childcare Workers","9385",9414,29,0.0031,3,632,657,1292,"11.09",NA,"Northeast"
"320","39-9031","Fitness Trainers and Aerobics Instructors","3682",4419,737,0.2002,74,237,384,695,"14.23",NA,"Northeast"
"321","39-9032","Recreation Workers","4794",5121,327,0.0682,33,290,471,794,"12.89",NA,"Northeast"
"322","39-9041","Residential Advisors","1063",1205,142,0.1336,14,57,102,173,"14.73",NA,"Northeast"
"323","41-0000","Sales and Related Occupations","190932",183270,-7662,-0.0401,-766,9382,14764,23380,"14.15",NA,"Northeast"
"324","41-1011","First-Line Supervisors of Retail Sales Workers","17487",16291,-1196,-0.0684,-120,597,1170,1647,"18.2",NA,"Northeast"
"325","41-1012","First-Line Supervisors of Non-Retail Sales Workers","5013",4561,-452,-0.0902,-45,139,284,378,"37.56",NA,"Northeast"
"326","41-2011","Cashiers","40384",35949,-4435,-0.1098,-444,3247,3654,6457,"10.96",NA,"Northeast"
"327","41-2022","Parts Salespersons","3599",3778,179,0.0497,18,155,282,455,"14.41",NA,"Northeast"
"328","41-2031","Retail Salespersons","50354",49116,-1238,-0.0246,-124,2781,4108,6765,"12.81",NA,"Northeast"
"329","41-3011","Advertising Sales Agents","1103",969,-134,-0.1215,-13,32,96,115,"23.26",NA,"Northeast"
"330","41-3021","Insurance Sales Agents","7045",7480,435,0.0617,44,242,406,692,"29.35",NA,"Northeast"
"331","41-3031","Securities, Commodities, and Financial Services Sales Agents","6679",6579,-100,-0.015,-10,147,418,555,"24.47",NA,"Northeast"
"332","41-3041","Travel Agents","516",511,-5,-0.0097,0,25,34,59,"17.8",NA,"Northeast"
"333","41-3091","Sales Representatives of Services, Except Advertising, Insurance, Financial Services, and Travel","10206",10794,588,0.0576,59,264,923,1246,"23.75",NA,"Northeast"
"334","41-4011","Sales Representatives, Wholesale and Manufacturing, Technical and Scientific Products","3057",3113,56,0.0183,6,91,208,305,"47.4",NA,"Northeast"
"335","41-4012","Sales Representatives, Wholesale and Manufacturing, Except Technical and Scientific Products","25349",25731,382,0.0151,38,755,1726,2519,"29.73",NA,"Northeast"
"336","41-9022","Real Estate Sales Agents","4020",4021,1,2e-04,0,167,177,344,"17.649999999999999",NA,"Northeast"
"337","41-9031","Sales Engineers","821",811,-10,-0.0122,-1,16,67,82,"47.76",NA,"Northeast"
"338","41-9041","Telemarketers","7564",6200,-1364,-0.1803,-136,318,703,885,"13.53",NA,"Northeast"
"339","43-0000","Office and Administrative Support Occupations","260750",246182,-14568,-0.0559,-1457,12026,15733,26302,"18.13",NA,"Northeast"
"340","43-1011","First-Line Supervisors of Office and Administrative Support Workers","16566",15784,-782,-0.0472,-78,600,988,1510,"28.99",NA,"Northeast"
"341","43-2011","Switchboard Operators, Including Answering Service","863",647,-216,-0.2503,-22,39,44,61,"17.57",NA,"Northeast"
"342","43-3011","Bill and Account Collectors","3372",3083,-289,-0.0857,-29,118,229,318,"17.739999999999998",NA,"Northeast"
"343","43-3021","Billing and Posting Clerks","6830",6796,-34,-0.005,-3,280,418,695,"18.12",NA,"Northeast"
"344","43-3031","Bookkeeping, Accounting, and Auditing Clerks","21195",20003,-1192,-0.0562,-119,1207,1052,2140,"18.899999999999999",NA,"Northeast"
"345","43-3051","Payroll and Timekeeping Clerks","2182",1827,-355,-0.1627,-36,95,110,169,"22.13",NA,"Northeast"
"346","43-3061","Procurement Clerks","1073",1018,-55,-0.0513,-6,29,66,89,"18.45",NA,"Northeast"
"347","43-3071","Tellers","6142",4692,-1450,-0.2361,-145,220,341,416,"16.850000000000001",NA,"Northeast"
"348","43-3099","Financial Clerks, All Other","368",365,-3,-0.0082,0,13,26,39,"22.73",NA,"Northeast"
"349","43-4011","Brokerage Clerks","617",560,-57,-0.0924,-6,24,39,57,"22.97",NA,"Northeast"
"350","43-4031","Court, Municipal, and License Clerks","3806",3919,113,0.0297,11,188,194,393,"18.23",NA,"Northeast"
"351","43-4051","Customer Service Representatives","44195",42878,-1317,-0.0298,-132,2047,3424,5339,"17.87",NA,"Northeast"
"352","43-4061","Eligibility Interviewers, Government Programs","1639",1668,29,0.0177,3,61,86,150,"21.88",NA,"Northeast"
"353","43-4071","File Clerks","947",779,-168,-0.1774,-17,47,53,83,"17.59",NA,"Northeast"
"354","43-4081","Hotel, Motel, and Resort Desk Clerks","1681",1924,243,0.1446,24,104,191,319,"11.29",NA,"Northeast"
"355","43-4111","Interviewers, Except Eligibility and Loan","1776",1592,-184,-0.1036,-18,97,109,188,"17.829999999999998",NA,"Northeast"
"356","43-4121","Library Assistants, Clerical","1722",1595,-127,-0.0738,-13,148,106,241,"11.2",NA,"Northeast"
"357","43-4131","Loan Interviewers and Clerks","2519",2391,-128,-0.0508,-13,71,144,202,"19.21",NA,"Northeast"
"358","43-4141","New Accounts Clerks","338",276,-62,-0.1834,-6,10,19,23,"22.58",NA,"Northeast"
"359","43-4151","Order Clerks","1706",1378,-328,-0.1923,-33,66,97,130,"17.91",NA,"Northeast"
"360","43-4161","Human Resources Assistants, Except Payroll and Timekeeping","1198",1153,-45,-0.0376,-4,45,71,112,"19.690000000000001",NA,"Northeast"
"361","43-4171","Receptionists and Information Clerks","12206",11743,-463,-0.0379,-46,668,827,1449,"14.09",NA,"Northeast"
"362","43-4181","Reservation and Transportation Ticket Agents and Travel Clerks","605",654,49,0.081,5,24,45,74,"17.07",NA,"Northeast"
"363","43-4199","Information and Record Clerks, All Other","962",1006,44,0.0457,4,40,65,109,"21",NA,"Northeast"
"364","43-5011","Cargo and Freight Agents","802",830,28,0.0349,3,31,48,82,"18.3",NA,"Northeast"
"365","43-5021","Couriers and Messengers","882",799,-83,-0.0941,-8,34,46,72,"14.44",NA,"Northeast"
"366","43-5031","Police, Fire, and Ambulance Dispatchers","1990",2078,88,0.0442,9,72,114,195,"22.89",NA,"Northeast"
"367","43-5032","Dispatchers, Except Police, Fire, and Ambulance","2839",2850,11,0.0039,1,100,159,260,"18.489999999999998",NA,"Northeast"
"368","43-5041","Meter Readers, Utilities","576",520,-56,-0.0972,-6,16,24,34,"28.54",NA,"Northeast"
"369","43-5051","Postal Service Clerks","946",848,-98,-0.1036,-10,41,32,63,"25.6",NA,"Northeast"
"370","43-5052","Postal Service Mail Carriers","4895",4387,-508,-0.1038,-51,161,166,276,"25.21",NA,"Northeast"
"371","43-5053","Postal Service Mail Sorters, Processors, and Processing Machine Operators","1387",1182,-205,-0.1478,-20,70,42,92,"21.77",NA,"Northeast"
"372","43-5061","Production, Planning, and Expediting Clerks","6238",6470,232,0.0372,23,227,413,663,"23.1",NA,"Northeast"
"373","43-5071","Shipping, Receiving, and Traffic Clerks","14495",13439,-1056,-0.0729,-106,510,821,1225,"17.739999999999998",NA,"Northeast"
"374","43-5111","Weighers, Measurers, Checkers, and Samplers, Recordkeeping","556",584,28,0.0504,3,22,32,57,"18.13",NA,"Northeast"
"375","43-6011","Executive Secretaries and Executive Administrative Assistants","4172",3292,-880,-0.2109,-88,190,208,310,"29.13",NA,"Northeast"
"376","43-6012","Legal Secretaries","2082",1613,-469,-0.2253,-47,94,103,150,"22.46",NA,"Northeast"
"377","43-6013","Medical Secretaries","12197",12667,470,0.0385,47,632,694,1373,"17.739999999999998",NA,"Northeast"
"378","43-6014","Secretaries and Administrative Assistants, Except Legal, Medical, and Executive","20817",18598,-2219,-0.1066,-222,1003,1100,1881,"17.84",NA,"Northeast"
"379","43-9021","Data Entry Keyers","2217",1724,-493,-0.2224,-49,88,125,164,"17.13",NA,"Northeast"
"380","43-9022","Word Processors and Typists","454",281,-173,-0.3811,-17,22,20,25,"18.190000000000001",NA,"Northeast"
"381","43-9041","Insurance Claims and Policy Processing Clerks","4142",4038,-104,-0.0251,-10,144,240,374,"18.73",NA,"Northeast"
"382","43-9051","Mail Clerks and Mail Machine Operators, Except Postal Service","1141",1100,-41,-0.0359,-4,57,70,123,"14.13",NA,"Northeast"
"383","43-9061","Office Clerks, General","40724",38497,-2227,-0.0547,-223,2162,2349,4288,"17.79",NA,"Northeast"
"384","45-0000","Farming, Fishing, and Forestry Occupations","3802",3924,122,0.0321,12,162,438,612,"15.14",NA,"Northeast"
"385","45-1011","First-Line Supervisors of Farming, Fishing, and Forestry Workers","171",182,11,0.0643,1,6,18,25,"26.97",NA,"Northeast"
"386","45-2091","Agricultural Equipment Operators","343",383,40,0.1166,4,15,42,61,"21.91",NA,"Northeast"
"387","45-2092","Farmworkers and Laborers, Crop, Nursery, and Greenhouse","2506",2595,89,0.0355,9,108,292,409,"14.33",NA,"Northeast"
"388","45-2093","Farmworkers, Farm, Ranch, and Aquacultural Animals","348",329,-19,-0.0546,-2,14,39,51,"13.73",NA,"Northeast"
"389","47-0000","Construction and Extraction Occupations","71931",74973,3042,0.0423,304,2196,4979,7479,"23.64",NA,"Northeast"
"390","47-1011","First-Line Supervisors of Construction Trades and Extraction Workers","5806",6094,288,0.0496,29,168,385,582,"30.12",NA,"Northeast"
"391","47-2011","Boilermakers","266",273,7,0.0263,1,4,19,24,"39.799999999999997",NA,"Northeast"
"392","47-2021","Brickmasons and Blockmasons","1570",1488,-82,-0.0522,-8,49,94,135,"29.47",NA,"Northeast"
"393","47-2031","Carpenters","8780",8963,183,0.0208,18,259,553,830,"23.14",NA,"Northeast"
"394","47-2041","Carpet Installers","298",281,-17,-0.057,-2,8,17,23,"18.850000000000001",NA,"Northeast"
"395","47-2044","Tile and Marble Setters","285",316,31,0.1088,3,8,18,29,"24.46",NA,"Northeast"
"396","47-2051","Cement Masons and Concrete Finishers","1835",1809,-26,-0.0142,-3,44,120,161,"23.7",NA,"Northeast"
"397","47-2061","Construction Laborers","15893",17075,1182,0.0744,118,487,1113,1718,"22.22",NA,"Northeast"
"398","47-2071","Paving, Surfacing, and Tamping Equipment Operators","308",320,12,0.039,1,10,22,33,"23.16",NA,"Northeast"
"399","47-2073","Operating Engineers and Other Construction Equipment Operators","5122",5313,191,0.0373,19,171,374,564,"28.73",NA,"Northeast"
"400","47-2081","Drywall and Ceiling Tile Installers","266",279,13,0.0489,1,7,15,23,"23.11",NA,"Northeast"
"401","47-2082","Tapers","132",133,1,0.0076,0,3,8,11,"29.02",NA,"Northeast"
"402","47-2111","Electricians","8179",8699,520,0.0636,52,245,620,917,"29.02",NA,"Northeast"
"403","47-2121","Glaziers","500",531,31,0.062,3,14,40,57,"25.19",NA,"Northeast"
"404","47-2131","Insulation Workers, Floor, Ceiling, and Wall","203",213,10,0.0493,1,5,14,20,"18.7",NA,"Northeast"
"405","47-2132","Insulation Workers, Mechanical","211",223,12,0.0569,1,5,15,21,"28.9",NA,"Northeast"
"406","47-2141","Painters, Construction and Maintenance","3785",3966,181,0.0478,18,117,215,350,"21.96",NA,"Northeast"
"407","47-2151","Pipelayers","234",239,5,0.0214,0,7,17,24,"23.09",NA,"Northeast"
"408","47-2152","Plumbers, Pipefitters, and Steamfitters","4089",4207,118,0.0289,12,121,298,431,"29.77",NA,"Northeast"
"409","47-2181","Roofers","2479",2609,130,0.0524,13,63,178,254,"22.47",NA,"Northeast"
"410","47-2211","Sheet Metal Workers","1452",1483,31,0.0213,3,40,95,138,"28.86",NA,"Northeast"
"411","47-2221","Structural Iron and Steel Workers","800",846,46,0.0575,5,21,63,89,"29.44",NA,"Northeast"
"412","47-3013","Helpers--Electricians","200",196,-4,-0.02,0,6,17,23,"14.81",NA,"Northeast"
"413","47-3016","Helpers--Roofers","137",144,7,0.0511,1,4,12,17,"17.97",NA,"Northeast"
"414","47-4011","Construction and Building Inspectors","1167",1095,-72,-0.0617,-7,62,68,123,"29.41",NA,"Northeast"
"415","47-4031","Fence Erectors","293",299,6,0.0205,1,7,22,30,"19.53",NA,"Northeast"
"416","47-4041","Hazardous Materials Removal Workers","792",811,19,0.024,2,30,65,97,"22.92",NA,"Northeast"
"417","47-4051","Highway Maintenance Workers","3232",3286,54,0.0167,5,128,204,337,"22.58",NA,"Northeast"
"418","47-4071","Septic Tank Servicers and Sewer Pipe Cleaners","722",772,50,0.0693,5,24,62,91,"22.72",NA,"Northeast"
"419","47-5013","Service Unit Operators, Oil, Gas, and Mining","145",141,-4,-0.0276,0,3,14,17,"18.7",NA,"Northeast"
"420","47-5022","Excavating and Loading Machine and Dragline Operators, Surface Mining","159",157,-2,-0.0126,0,5,14,19,"22.58",NA,"Northeast"
"421","47-5071","Roustabouts, Oil and Gas","185",206,21,0.1135,2,4,19,25,"14.7",NA,"Northeast"
"422","49-0000","Installation, Maintenance, and Repair Occupations","80265",82661,2396,0.0299,240,2586,5130,7956,"22.94",NA,"Northeast"
"423","49-1011","First-Line Supervisors of Mechanics, Installers, and Repairers","5525",5688,163,0.0295,16,163,334,513,"30.75",NA,"Northeast"
"424","49-2011","Computer, Automated Teller, and Office Machine Repairers","1765",1560,-205,-0.1161,-20,50,126,156,"18.489999999999998",NA,"Northeast"
"425","49-2021","Radio, Cellular, and Tower Equipment Installers and Repairers","146",142,-4,-0.0274,0,5,11,16,"28.01",NA,"Northeast"
"426","49-2022","Telecommunications Equipment Installers and Repairers, Except Line Installers","1969",1782,-187,-0.095,-19,65,144,190,"29.42",NA,"Northeast"
"427","49-2092","Electric Motor, Power Tool, and Related Repairers","379",406,27,0.0712,3,15,23,41,"23.09",NA,"Northeast"
"428","49-2093","Electrical and Electronics Installers and Repairers, Transportation Equipment","147",141,-6,-0.0408,-1,4,7,10,"30.03","†","Northeast"
"429","49-2094","Electrical and Electronics Repairers, Commercial and Industrial Equipment","536",559,23,0.0429,2,15,27,44,"24.71",NA,"Northeast"
"430","49-2095","Electrical and Electronics Repairers, Powerhouse, Substation, and Relay","317",305,-12,-0.0379,-1,9,15,23,"38.58",NA,"Northeast"
"431","49-2098","Security and Fire Alarm Systems Installers","1000",959,-41,-0.041,-4,23,75,94,"23.09",NA,"Northeast"
"432","49-3011","Aircraft Mechanics and Service Technicians","994",1060,66,0.0664,7,29,54,90,"30.57",NA,"Northeast"
"433","49-3021","Automotive Body and Related Repairers","1953",2016,63,0.0323,6,63,118,187,"22.52",NA,"Northeast"
"434","49-3022","Automotive Glass Installers and Repairers","284",301,17,0.0599,2,9,21,32,"22.45",NA,"Northeast"
"435","49-3023","Automotive Service Technicians and Mechanics","10756",10668,-88,-0.0082,-9,318,727,1036,"19.89",NA,"Northeast"
"436","49-3031","Bus and Truck Mechanics and Diesel Engine Specialists","3463",3621,158,0.0456,16,100,221,337,"23.03",NA,"Northeast"
"437","49-3041","Farm Equipment Mechanics and Service Technicians","449",479,30,0.0668,3,14,31,48,"22.32",NA,"Northeast"
"438","49-3042","Mobile Heavy Equipment Mechanics, Except Engines","1594",1688,94,0.059,9,49,111,169,"27.39",NA,"Northeast"
"439","49-3043","Rail Car Repairers","171",174,3,0.0175,0,5,12,17,"18.55",NA,"Northeast"
"440","49-3052","Motorcycle Mechanics","287",311,24,0.0836,2,13,20,35,"18.05",NA,"Northeast"
"441","49-3053","Outdoor Power Equipment and Other Small Engine Mechanics","577",581,4,0.0069,0,25,38,63,"17.46",NA,"Northeast"
"442","49-3092","Recreational Vehicle Service Technicians","208",249,41,0.1971,4,7,19,30,"17.809999999999999",NA,"Northeast"
"443","49-3093","Tire Repairers and Changers","864",900,36,0.0417,4,27,73,104,"14.63",NA,"Northeast"
"444","49-9011","Mechanical Door Repairers","526",584,58,0.1103,6,13,32,51,"19.260000000000002",NA,"Northeast"
"445","49-9012","Control and Valve Installers and Repairers, Except Mechanical Door","315",314,-1,-0.0032,0,7,18,25,"35.76",NA,"Northeast"
"446","49-9021","Heating, Air Conditioning, and Refrigeration Mechanics and Installers","4936",5079,143,0.029,14,128,342,484,"23.51",NA,"Northeast"
"447","49-9031","Home Appliance Repairers","519",475,-44,-0.0848,-4,19,29,44,"22.36",NA,"Northeast"
"448","49-9041","Industrial Machinery Mechanics","7061",8454,1393,0.1973,139,238,419,796,"28.4",NA,"Northeast"
"449","49-9043","Maintenance Workers, Machinery","1031",1110,79,0.0766,8,36,58,102,"24.4",NA,"Northeast"
"450","49-9044","Millwrights","497",544,47,0.0946,5,15,30,50,"29.07",NA,"Northeast"
"451","49-9051","Electrical Power-Line Installers and Repairers","915",937,22,0.024,2,17,62,81,"38.58",NA,"Northeast"
"452","49-9052","Telecommunications Line Installers and Repairers","1921",1678,-243,-0.1265,-24,40,152,168,"22.77",NA,"Northeast"
"453","49-9062","Medical Equipment Repairers","993",1033,40,0.0403,4,44,61,109,"25.03",NA,"Northeast"
"454","49-9071","Maintenance and Repair Workers, General","22476",23226,750,0.0334,75,805,1333,2213,"22.28",NA,"Northeast"
"455","49-9091","Coin, Vending, and Amusement Machine Servicers and Repairers","484",497,13,0.0269,1,22,36,59,"16.239999999999998",NA,"Northeast"
"456","49-9094","Locksmiths and Safe Repairers","145",114,-31,-0.2138,-3,5,8,10,"22.02",NA,"Northeast"
"457","49-9098","Helpers--Installation, Maintenance, and Repair Workers","757",789,32,0.0423,3,33,65,101,"17.48",NA,"Northeast"
"458","49-9099","Installation, Maintenance, and Repair Workers, All Other","2810",2916,106,0.0377,11,101,191,303,"18.91",NA,"Northeast"
"459","51-0000","Production Occupations","181320",174479,-6841,-0.0377,-684,6541,12602,18459,"18.13",NA,"Northeast"
"460","51-1011","First-Line Supervisors of Production and Operating Workers","12151",12315,164,0.0135,16,368,823,1207,"29.4",NA,"Northeast"
"461","51-2021","Coil Winders, Tapers, and Finishers","329",273,-56,-0.1702,-6,12,19,25,"18.350000000000001",NA,"Northeast"
"462","51-2028","Electrical, Electronic, and Electromechanical Assemblers, Except Coil Winders, Tapers, and Finishers","2899",2946,47,0.0162,5,118,187,310,"16.54",NA,"Northeast"
"463","51-2041","Structural Metal Fabricators and Fitters","1408",1223,-185,-0.1314,-18,30,105,117,"19.55",NA,"Northeast"
"464","51-2090","Miscellaneous Assemblers and Fabricators","29221",26381,-2840,-0.0972,-284,1061,1984,2761,"16.329999999999998",NA,"Northeast"
"465","51-3011","Bakers","3795",3959,164,0.0432,16,216,290,522,"13.73",NA,"Northeast"
"466","51-3021","Butchers and Meat Cutters","1193",1081,-112,-0.0939,-11,46,84,119,"14.3",NA,"Northeast"
"467","51-3022","Meat, Poultry, and Fish Cutters and Trimmers","1412",1434,22,0.0156,2,58,106,166,"14.21",NA,"Northeast"
"468","51-3023","Slaughterers and Meat Packers","1723",1841,118,0.0685,12,72,132,216,"14.08",NA,"Northeast"
"469","51-3092","Food Batchmakers","2425",2462,37,0.0153,4,114,182,300,"14.5",NA,"Northeast"
"470","51-3093","Food Cooking Machine Operators and Tenders","492",509,17,0.0346,2,35,50,87,"18.350000000000001",NA,"Northeast"
"471","51-4021","Extruding and Drawing Machine Setters, Operators, and Tenders, Metal and Plastic","2422",2199,-223,-0.0921,-22,80,143,201,"18.09",NA,"Northeast"
"472","51-4022","Forging Machine Setters, Operators, and Tenders, Metal and Plastic","730",613,-117,-0.1603,-12,23,41,52,"21.24",NA,"Northeast"
"473","51-4023","Rolling Machine Setters, Operators, and Tenders, Metal and Plastic","2124",1866,-258,-0.1215,-26,70,123,167,"23",NA,"Northeast"
"474","51-4031","Cutting, Punching, and Press Machine Setters, Operators, and Tenders, Metal and Plastic","6512",6086,-426,-0.0654,-43,200,433,590,"18.11",NA,"Northeast"
"475","51-4033","Grinding, Lapping, Polishing, and Buffing Machine Tool Setters, Operators, and Tenders, Metal and Plastic","2998",2795,-203,-0.0677,-20,130,199,309,"17.47",NA,"Northeast"
"476","51-4034","Lathe and Turning Machine Tool Setters, Operators, and Tenders, Metal and Plastic","1082",981,-101,-0.0933,-10,34,70,94,"21.74",NA,"Northeast"
"477","51-4041","Machinists","10120",10585,465,0.0459,46,346,704,1096,"19",NA,"Northeast"
"478","51-4051","Metal-Refining Furnace Operators and Tenders","573",560,-13,-0.0227,-1,12,39,50,"18.3",NA,"Northeast"
"479","51-4052","Pourers and Casters, Metal","579",525,-54,-0.0933,-5,12,38,45,"23.29",NA,"Northeast"
"480","51-4062","Patternmakers, Metal and Plastic","111",103,-8,-0.0721,-1,4,7,10,"23.75",NA,"Northeast"
"481","51-4071","Foundry Mold and Coremakers","1789",1699,-90,-0.0503,-9,57,118,166,"21.17",NA,"Northeast"
"482","51-4072","Molding, Coremaking, and Casting Machine Setters, Operators, and Tenders, Metal and Plastic","7329",6693,-636,-0.0868,-64,228,475,639,"16.97",NA,"Northeast"
"483","51-4081","Multiple Machine Tool Setters, Operators, and Tenders, Metal and Plastic","5206",5377,171,0.0328,17,172,358,547,"18.14",NA,"Northeast"
"484","51-4111","Tool and Die Makers","2229",2165,-64,-0.0287,-6,81,138,213,"23.65",NA,"Northeast"
"485","51-4121","Welders, Cutters, Solderers, and Brazers","6245",6682,437,0.07,44,170,510,724,"21.6",NA,"Northeast"
"486","51-4122","Welding, Soldering, and Brazing Machine Setters, Operators, and Tenders","765",716,-49,-0.0641,-5,20,58,73,"18.170000000000002",NA,"Northeast"
"487","51-4191","Heat Treating Equipment Setters, Operators, and Tenders, Metal and Plastic","948",862,-86,-0.0907,-9,29,61,81,"18.82",NA,"Northeast"
"488","51-4193","Plating and Coating Machine Setters, Operators, and Tenders, Metal and Plastic","1290",1220,-70,-0.0543,-7,41,85,119,"17.48",NA,"Northeast"
"489","51-4194","Tool Grinders, Filers, and Sharpeners","125",113,-12,-0.096,-1,4,8,11,"23.18",NA,"Northeast"
"490","51-4199","Metal Workers and Plastic Workers, All Other","305",283,-22,-0.0721,-2,10,20,28,"17.78",NA,"Northeast"
"491","51-5111","Prepress Technicians and Workers","600",489,-111,-0.185,-11,21,52,62,"21.23",NA,"Northeast"
"492","51-5112","Printing Press Operators","3372",3046,-326,-0.0967,-33,116,226,309,"18.13",NA,"Northeast"
"493","51-5113","Print Binding and Finishing Workers","984",749,-235,-0.2388,-24,43,54,73,"16.73",NA,"Northeast"
"494","51-6011","Laundry and Dry-Cleaning Workers","2554",2697,143,0.056,14,170,176,360,"11.46",NA,"Northeast"
"495","51-6021","Pressers, Textile, Garment, and Related Materials","165",144,-21,-0.1273,-2,7,9,14,"11.25",NA,"Northeast"
"496","51-6031","Sewing Machine Operators","1959",1796,-163,-0.0832,-16,114,99,197,"13.95",NA,"Northeast"
"497","51-6052","Tailors, Dressmakers, and Custom Sewers","552",477,-75,-0.1359,-8,41,26,59,"14.35",NA,"Northeast"
"498","51-6091","Extruding and Forming Machine Setters, Operators, and Tenders, Synthetic and Glass Fibers","166",161,-5,-0.0301,0,9,11,20,"14.43",NA,"Northeast"
"499","51-7011","Cabinetmakers and Bench Carpenters","1524",1625,101,0.0663,10,59,87,156,"18.170000000000002",NA,"Northeast"
"500","51-7021","Furniture Finishers","602",640,38,0.0631,4,36,46,86,"17.739999999999998",NA,"Northeast"
"501","51-7041","Sawing Machine Setters, Operators, and Tenders, Wood","311",326,15,0.0482,2,11,24,37,"17.829999999999998",NA,"Northeast"
"502","51-7042","Woodworking Machine Setters, Operators, and Tenders, Except Sawing","1190",1308,118,0.0992,12,37,90,139,"17.48",NA,"Northeast"
"503","51-8012","Power Distributors and Dispatchers","286",265,-21,-0.0734,-2,7,18,23,"46.68",NA,"Northeast"
"504","51-8021","Stationary Engineers and Boiler Operators","375",385,10,0.0267,1,18,27,46,"30.24",NA,"Northeast"
"505","51-8031","Water and Wastewater Treatment Plant and System Operators","1402",1300,-102,-0.0728,-10,38,84,112,"23.61",NA,"Northeast"
"506","51-8091","Chemical Plant and System Operators","327",316,-11,-0.0336,-1,8,25,32,"29.28",NA,"Northeast"
"507","51-8093","Petroleum Pump System Operators, Refinery Operators, and Gaugers","188",195,7,0.0372,1,4,15,20,"45.73",NA,"Northeast"
"508","51-9011","Chemical Equipment Operators and Tenders","2228",2059,-169,-0.0759,-17,47,166,196,"22.78",NA,"Northeast"
"509","51-9012","Separating, Filtering, Clarifying, Precipitating, and Still Machine Setters, Operators, and Tenders","482",484,2,0.0041,0,11,38,49,"18.059999999999999",NA,"Northeast"
"510","51-9021","Crushing, Grinding, and Polishing Machine Setters, Operators, and Tenders","777",756,-21,-0.027,-2,26,57,81,"18.39",NA,"Northeast"
"511","51-9022","Grinding and Polishing Workers, Hand","505",419,-86,-0.1703,-9,16,34,41,"17.59",NA,"Northeast"
"512","51-9023","Mixing and Blending Machine Setters, Operators, and Tenders","3088",3131,43,0.0139,4,105,232,341,"18.13",NA,"Northeast"
"513","51-9032","Cutting and Slicing Machine Setters, Operators, and Tenders","981",936,-45,-0.0459,-4,43,73,112,"18.13",NA,"Northeast"
"514","51-9041","Extruding, Forming, Pressing, and Compacting Machine Setters, Operators, and Tenders","2184",2123,-61,-0.0279,-6,59,159,212,"16.96",NA,"Northeast"
"515","51-9051","Furnace, Kiln, Oven, Drier, and Kettle Operators and Tenders","390",403,13,0.0333,1,14,24,39,"18.2",NA,"Northeast"
"516","51-9061","Inspectors, Testers, Sorters, Samplers, and Weighers","11059",9349,-1710,-0.1546,-171,392,810,1031,"18.25",NA,"Northeast"
"517","51-9071","Jewelers and Precious Stone and Metal Workers","228",203,-25,-0.1096,-2,12,14,24,"21.55",NA,"Northeast"
"518","51-9081","Dental Laboratory Technicians","631",644,13,0.0206,1,29,52,82,"22.53",NA,"Northeast"
"519","51-9082","Medical Appliance Technicians","224",242,18,0.0804,2,10,19,31,"17.920000000000002",NA,"Northeast"
"520","51-9111","Packaging and Filling Machine Operators and Tenders","6495",6714,219,0.0337,22,272,438,732,"16.739999999999998",NA,"Northeast"
"521","51-9123","Painting, Coating, and Decorating Workers","184",186,2,0.0109,0,5,13,18,"18.05",NA,"Northeast"
"522","51-9124","Coating, Painting, and Spraying Machine Setters, Operators, and Tenders","3216",3323,107,0.0333,11,90,234,335,"18.329999999999998",NA,"Northeast"
"523","51-9151","Photographic Process Workers and Processing Machine Operators","203",187,-16,-0.0788,-2,9,20,27,"17.91",NA,"Northeast"
"524","51-9161","Computer Numerically Controlled Tool Operators","4960",4698,-262,-0.0528,-26,165,357,496,"21.65",NA,"Northeast"
"525","51-9162","Computer Numerically Controlled Tool Programmers","1008",1233,225,0.2232,22,38,83,143,"27.89",NA,"Northeast"
"526","51-9191","Adhesive Bonding Machine Operators and Tenders","270",271,1,0.0037,0,15,18,33,"17.59",NA,"Northeast"
"527","51-9193","Cooling and Freezing Equipment Operators and Tenders","348",367,19,0.0546,2,12,26,40,"22.81",NA,"Northeast"
"528","51-9195","Molders, Shapers, and Casters, Except Metal and Plastic","1303",1504,201,0.1543,20,50,92,162,"18.02",NA,"Northeast"
"529","51-9196","Paper Goods Machine Setters, Operators, and Tenders","1768",1656,-112,-0.0633,-11,77,114,180,"18.399999999999999",NA,"Northeast"
"530","51-9198","Helpers--Production Workers","2755",2508,-247,-0.0897,-25,124,248,347,"16.86",NA,"Northeast"
"531","51-9199","Production Workers, All Other","2625",2723,98,0.0373,10,92,198,300,"17.739999999999998",NA,"Northeast"
"532","53-0000","Transportation and Material Moving Occupations","163391",174827,11436,0.07,1144,7815,13373,22332,"17.440000000000001",NA,"Northeast"
"533","53-1047","FirstLine Supervisors of Transportation & Material Moving Workers, Exc Aircraft Cargo Handling Supervisor","7259",7404,145,0.02,14,268,508,790,"23.55",NA,"Northeast"
"534","53-2011","Airline Pilots, Copilots, and Flight Engineers","347",352,5,0.0144,0,13,25,38,"#",NA,"Northeast"
"535","53-2012","Commercial Pilots","353",393,40,0.1133,4,14,26,44,"97474","**","Northeast"
"536","53-2021","Air Traffic Controllers","626",671,45,0.0719,4,17,45,66,"73.430000000000007",NA,"Northeast"
"537","53-3031","Driver/Sales Workers","11181",12600,1419,0.1269,142,487,806,1435,"11.42",NA,"Northeast"
"538","53-3032","Heavy and Tractor-Trailer Truck Drivers","26602",27609,1007,0.0379,101,1110,1838,3049,"22.95",NA,"Northeast"
"539","53-3033","Light Truck or Delivery Services Drivers","12293",13426,1133,0.0922,113,527,872,1512,"17.72",NA,"Northeast"
"540","53-3052","Bus Drivers, Transit and Intercity","1914",2142,228,0.1191,23,134,101,258,"26.63",NA,"Northeast"
"541","53-3058","Passenger Vehicle Drivers, Except Bus Drivers, Transit and Intercity","6435",8395,1960,0.3046,196,488,369,1053,"18.05","^^^","Northeast"
"542","53-6021","Parking Lot Attendants","1338",1424,86,0.0643,9,67,143,219,"11.39",NA,"Northeast"
"543","53-6031","Automotive and Watercraft Service Attendants","976",1023,47,0.0482,5,46,89,140,"13.72",NA,"Northeast"
"544","53-6051","Transportation Inspectors","315",321,6,0.019,1,11,23,35,"36.700000000000003",NA,"Northeast"
"545","53-6098","Aircraft Service Attendants and Transportation Workers, All Other","311",337,26,0.0836,3,15,29,47,"14.39","^^^","Northeast"
"546","53-7011","Conveyor Operators and Tenders","170",175,5,0.0294,0,5,15,20,"14.97",NA,"Northeast"
"547","53-7021","Crane and Tower Operators","686",689,3,0.0044,0,19,52,71,"22.71",NA,"Northeast"
"548","53-7051","Industrial Truck and Tractor Operators","7918",8607,689,0.087,69,249,634,952,"18.45",NA,"Northeast"
"549","53-7061","Cleaners of Vehicles and Equipment","4508",4737,229,0.0508,23,226,412,661,"13.82",NA,"Northeast"
"550","53-7062","Laborers and Freight, Stock, and Material Movers, Hand","36510",38974,2464,0.0675,246,1652,3284,5182,"15.21",NA,"Northeast"
"551","53-7064","Packers and Packagers, Hand","7337",7425,88,0.012,9,420,598,1027,"14.33",NA,"Northeast"
"552","53-7065","Stockers and Order Fillers","30553",32028,1475,0.0483,148,1781,3052,4981,"14.26",NA,"Northeast"
"553","53-7081","Refuse and Recyclable Material Collectors","1903",2075,172,0.0904,17,84,179,280,"18.41",NA,"Northeast"
"554","00-0000","Total, All Occupations","1168921",1261966,93045,0.0796,9304,50873,79184,139361,"22.4",NA,"Central"
"555","11-0000","Management Occupations","70397",77059,6662,0.0946,666,2143,3818,6627,"48.2",NA,"Central"
"556","11-1011","Chief Executives","1830",1671,-159,-0.0869,-16,48,71,103,"80.739999999999995",NA,"Central"
"557","11-1021","General and Operations Managers","14405",15779,1374,0.0954,137,301,936,1374,"47.63",NA,"Central"
"558","11-1031","Legislators","336",372,36,0.1071,4,8,17,29,"37738","**","Central"
"559","11-2021","Marketing Managers","1777",1869,92,0.0518,9,36,115,160,"62.05",NA,"Central"
"560","11-2022","Sales Managers","2537",2668,131,0.0516,13,52,164,229,"61.39",NA,"Central"
"561","11-2030","Public Relations and Fundraising Managers","376",413,37,0.0984,4,10,22,36,"57.62","^","Central"
"562","11-3010","Administrative Services and Facilities Managers","2900",3152,252,0.0869,25,86,151,262,"47.73","^","Central"
"563","11-3021","Computer and Information Systems Managers","3250",3353,103,0.0317,10,54,188,252,"63.05",NA,"Central"
"564","11-3031","Financial Managers","5457",6422,965,0.1768,96,122,298,516,"61.39",NA,"Central"
"565","11-3051","Industrial Production Managers","1368",1455,87,0.0636,9,27,67,103,"48.25",NA,"Central"
"566","11-3061","Purchasing Managers","430",459,29,0.0674,3,10,24,37,"61.12",NA,"Central"
"567","11-3071","Transportation, Storage, and Distribution Managers","1446",1674,228,0.1577,23,30,86,139,"40.97",NA,"Central"
"568","11-3111","Compensation and Benefits Managers","157",160,3,0.0191,0,3,8,11,"61.39",NA,"Central"
"569","11-3121","Human Resources Managers","1017",1101,84,0.0826,8,24,59,91,"60.88",NA,"Central"
"570","11-3131","Training and Development Managers","264",294,30,0.1136,3,6,18,27,"50.4",NA,"Central"
"571","11-9013","Farmers, Ranchers, and Other Agricultural Managers","11389",11903,514,0.0451,51,718,405,1174,"35.119999999999997","^","Central"
"572","11-9021","Construction Managers","2579",2927,348,0.1349,35,57,139,231,"47.76",NA,"Central"
"573","11-9031","Education Administrators, Preschool and Childcare Center/Program","414",506,92,0.2222,9,11,21,41,"22.23",NA,"Central"
"574","11-9032","Education Administrators, Elementary and Secondary School","1715",1887,172,0.1003,17,44,84,145,"98308","**","Central"
"575","11-9033","Education Administrators, Postsecondary","1077",1121,44,0.0409,4,27,51,82,"50.75",NA,"Central"
"576","11-9039","Education Administrators, All Other","254",291,37,0.1457,4,7,13,24,"38.46",NA,"Central"
"577","11-9041","Architectural and Engineering Managers","1158",1208,50,0.0432,5,21,60,86,"63.35",NA,"Central"
"578","11-9051","Food Service Managers","2322",2556,234,0.1008,23,75,195,293,"28.6",NA,"Central"
"579","11-9111","Medical and Health Services Managers","3463",4771,1308,0.3777,131,103,209,443,"47.76",NA,"Central"
"580","11-9121","Natural Sciences Managers","283",296,13,0.0459,1,6,14,21,"49.32",NA,"Central"
"581","11-9141","Property, Real Estate, and Community Association Managers","2807",2916,109,0.0388,11,109,108,228,"22.86",NA,"Central"
"582","11-9151","Social and Community Service Managers","948",1081,133,0.1403,13,30,54,97,"30.6",NA,"Central"
"583","11-9198","Personal Service Managers; Entertainment & Recreation Managers, Except Gambling; and Managers, All Other","3629",3905,276,0.0761,28,87,185,300,"59.93","^^^","Central"
"584","13-0000","Business and Financial Operations Occupations","93671",100405,6734,0.0719,673,2532,5621,8826,"33.24",NA,"Central"
"585","13-1020","Buyers and Purchasing Agents","3783",3570,-213,-0.0563,-21,125,236,340,"30.69",NA,"Central"
"586","13-1031","Claims Adjusters, Examiners, and Investigators","5081",4979,-102,-0.0201,-10,118,261,369,"29.6",NA,"Central"
"587","13-1041","Compliance Officers","2647",2837,190,0.0718,19,66,146,231,"36.57",NA,"Central"
"588","13-1051","Cost Estimators","1556",1596,40,0.0257,4,44,95,143,"30.63",NA,"Central"
"589","13-1071","Human Resources Specialists","8469",9349,880,0.1039,88,241,592,921,"29.41",NA,"Central"
"590","13-1075","Labor Relations Specialists","631",592,-39,-0.0618,-4,17,41,54,"38.76",NA,"Central"
"591","13-1081","Logisticians","1767",2305,538,0.3045,54,43,132,229,"37.24",NA,"Central"
"592","13-1111","Management Analysts","9400",10277,877,0.0933,88,316,566,970,"38.17",NA,"Central"
"593","13-1121","Meeting, Convention, and Event Planners","794",902,108,0.136,11,25,62,98,"28.89",NA,"Central"
"594","13-1131","Fundraisers","1233",1424,191,0.1549,19,41,84,144,"29.16",NA,"Central"
"595","13-1141","Compensation, Benefits, and Job Analysis Specialists","815",911,96,0.1178,10,26,50,86,"29.38",NA,"Central"
"596","13-1151","Training and Development Specialists","3740",4162,422,0.1128,42,119,242,403,"24.01",NA,"Central"
"597","13-1161","Market Research Analysts and Marketing Specialists","6958",8228,1270,0.1825,127,180,555,862,"30.05",NA,"Central"
"598","13-1198","Project Management Specialists and Business Operations Specialists, All Other","17598",18297,699,0.0397,70,416,880,1366,"35.9","^^^","Central"
"599","13-2011","Accountants and Auditors","12915",13692,777,0.0602,78,371,788,1237,"36.57",NA,"Central"
"600","13-2020","Property Appraisers and Assessors","1013",1055,42,0.0415,4,39,38,81,"37.24",NA,"Central"
"601","13-2031","Budget Analysts","213",229,16,0.0751,2,5,12,19,"38.92",NA,"Central"
"602","13-2041","Credit Analysts","832",823,-9,-0.0108,-1,14,56,69,"30.78",NA,"Central"
"603","13-2052","Personal Financial Advisors","1821",2034,213,0.117,21,44,95,160,"39.61",NA,"Central"
"604","13-2053","Insurance Underwriters","1448",1375,-73,-0.0504,-7,29,73,95,"37.21",NA,"Central"
"605","13-2061","Financial Examiners","1376",1678,302,0.2195,30,40,71,141,"37.24",NA,"Central"
"606","13-2072","Loan Officers","3341",3466,125,0.0374,12,73,185,270,"30.37",NA,"Central"
"607","13-2081","Tax Examiners and Collectors, and Revenue Agents","501",493,-8,-0.016,-1,19,22,40,"30.51",NA,"Central"
"608","13-2098","Financial and Investment Analysts, Financial Risk Specialists, and Financial Specialists, All Other","5074",5451,377,0.0743,38,92,300,430,"35.21","^^^","Central"
"609","15-0000","Computer and Mathematical Occupations","51108",54044,2936,0.0574,294,1097,2593,3984,"39.47",NA,"Central"
"610","15-1211","Computer Systems Analysts","7387",7391,4,5e-04,0,144,364,508,"47.34",NA,"Central"
"611","15-1212","Information Security Analysts","1589",1993,404,0.2542,40,28,99,167,"47.76",NA,"Central"
"612","15-1231","Computer Network Support Specialists","2125",2255,130,0.0612,13,41,116,170,"30.03",NA,"Central"
"613","15-1232","Computer User Support Specialists","5561",5561,0,0,0,104,294,398,"23.12",NA,"Central"
"614","15-1244","Network and Computer Systems Administrators","2715",2768,53,0.0195,5,46,129,180,"38.799999999999997",NA,"Central"
"615","15-1245","Database Administrators and Architects","1454",1490,36,0.0248,4,34,72,110,"47.44","^^^","Central"
"616","15-1251","Computer Programmers","1560",1211,-349,-0.2237,-35,28,63,56,"39.18",NA,"Central"
"617","15-1256","Software Developers and Software Quality Assurance Analysts and Testers","18223",20025,1802,0.0989,180,444,938,1562,"49.49","^^^","Central"
"618","15-1257","Web Developers and Digital Interface Designers","1680",1718,38,0.0226,4,39,83,126,"49.49","^^^","Central"
"619","15-1299","Computer Occupations, All Other","4168",4363,195,0.0468,20,99,209,328,"47.76",NA,"Central"
"620","15-2011","Actuaries","546",674,128,0.2344,13,10,24,47,"48.54",NA,"Central"
"621","15-2031","Operations Research Analysts","1492",1762,270,0.181,27,35,71,133,"41.3",NA,"Central"
"622","15-2098","Data Scientists and Mathematical Science Occupations, All Other","699",833,134,0.1917,13,16,38,67,"30.03","^^^","Central"
"623","17-0000","Architecture and Engineering Occupations","17908",19014,1106,0.0618,111,434,867,1412,"37.380000000000003",NA,"Central"
"624","17-1011","Architects, Except Landscape and Naval","946",986,40,0.0423,4,26,41,71,"37.450000000000003",NA,"Central"
"625","17-1022","Surveyors","225",230,5,0.0222,0,8,11,19,"29.68",NA,"Central"
"626","17-2011","Aerospace Engineers","116",130,14,0.1207,1,2,4,7,"49.05",NA,"Central"
"627","17-2031","Biomedical Engineers","147",152,5,0.034,0,3,6,9,"47.49",NA,"Central"
"628","17-2041","Chemical Engineers","188",203,15,0.0798,2,4,7,13,"47.31",NA,"Central"
"629","17-2051","Civil Engineers","1678",1832,154,0.0918,15,35,87,137,"37.950000000000003",NA,"Central"
"630","17-2061","Computer Hardware Engineers","199",197,-2,-0.0101,0,4,9,13,"37.619999999999997",NA,"Central"
"631","17-2071","Electrical Engineers","1468",1616,148,0.1008,15,37,62,114,"47.36",NA,"Central"
"632","17-2072","Electronics Engineers, Except Computer","721",755,34,0.0472,3,18,30,51,"46.19",NA,"Central"
"633","17-2081","Environmental Engineers","309",331,22,0.0712,2,8,16,26,"39.479999999999997",NA,"Central"
"634","17-2112","Industrial Engineers","2909",3248,339,0.1165,34,67,123,224,"38.799999999999997",NA,"Central"
"635","17-2131","Materials Engineers","254",280,26,0.1024,3,5,10,18,"39.92",NA,"Central"
"636","17-2141","Mechanical Engineers","2695",2879,184,0.0683,18,48,115,181,"38.049999999999997",NA,"Central"
"637","17-2199","Engineers, All Other","1485",1529,44,0.0296,4,32,62,98,"38.950000000000003",NA,"Central"
"638","17-3011","Architectural and Civil Drafters","721",712,-9,-0.0125,-1,22,46,67,"29.02",NA,"Central"
"639","17-3012","Electrical and Electronics Drafters","128",130,2,0.0156,0,4,8,12,"28.42",NA,"Central"
"640","17-3013","Mechanical Drafters","432",400,-32,-0.0741,-3,13,26,36,"29.19",NA,"Central"
"641","17-3022","Civil Engineering Technicians","330",343,13,0.0394,1,10,21,32,"29.03",NA,"Central"
"642","17-3023","Electrical and Electronics Engineering Technicians","532",536,4,0.0075,0,16,33,49,"31.99",NA,"Central"
"643","17-3025","Environmental Engineering Technicians","120",128,8,0.0667,1,4,8,13,"18.14",NA,"Central"
"644","17-3026","Industrial Engineering Technicians","563",594,31,0.0551,3,17,36,56,"28.95",NA,"Central"
"645","17-3027","Mechanical Engineering Technicians","282",295,13,0.0461,1,9,18,28,"29.04",NA,"Central"
"646","17-3031","Surveying and Mapping Technicians","281",290,9,0.032,1,10,25,36,"22.64",NA,"Central"
"647","17-3098","Calibration and Engineering Technologists and Technicians, Except Drafters, All Other","390",407,17,0.0436,2,12,24,38,"29.18","^^^","Central"
"648","19-0000","Life, Physical, and Social Science Occupations","9453",10153,700,0.0741,70,203,674,947,"31.28",NA,"Central"
"649","19-1012","Food Scientists and Technologists","141",148,7,0.0496,1,3,12,16,"39.4",NA,"Central"
"650","19-1041","Epidemiologists","177",235,58,0.3277,6,3,12,21,"37.380000000000003",NA,"Central"
"651","19-1042","Medical Scientists, Except Epidemiologists","975",1142,167,0.1713,17,14,61,92,"37.32",NA,"Central"
"652","19-2031","Chemists","671",731,60,0.0894,6,10,52,68,"37.159999999999997",NA,"Central"
"653","19-2041","Environmental Scientists and Specialists, Including Health","741",751,10,0.0135,1,12,59,72,"39.270000000000003",NA,"Central"
"654","19-2043","Hydrologists","175",182,7,0.04,1,3,14,18,"39.53",NA,"Central"
"655","19-2099","Physical Scientists, All Other","125",122,-3,-0.024,0,2,8,10,"39.270000000000003",NA,"Central"
"656","19-3031","Clinical, Counseling, and School Psychologists","817",921,104,0.1273,10,23,34,67,"38.96","^^^","Central"
"657","19-3051","Urban and Regional Planners","125",136,11,0.088,1,2,9,12,"30.33",NA,"Central"
"658","19-3099","Social Scientists and Related Workers, All Other","683",678,-5,-0.0073,0,15,45,60,"39.53",NA,"Central"
"659","19-4021","Biological Technicians","931",994,63,0.0677,6,23,96,125,"23.03",NA,"Central"
"660","19-4031","Chemical Technicians","400",417,17,0.0425,2,7,37,46,"24.17",NA,"Central"
"661","19-4042","Environmental Science and Protection Technicians, Including Health","303",331,28,0.0924,3,8,30,41,"17.760000000000002",NA,"Central"
"662","19-4061","Social Science Research Assistants","121",131,10,0.0826,1,3,12,16,"30.36",NA,"Central"
"663","19-4092","Forensic Science Technicians","155",177,22,0.1419,2,4,16,22,"30.89",NA,"Central"
"664","19-4099","Life, Physical, and Social Science Technicians, All Other","223",242,19,0.0852,2,6,22,30,"24.11",NA,"Central"
"665","19-5011","Occupational Health and Safety Specialists","1103",1162,59,0.0535,6,31,49,86,"37.979999999999997",NA,"Central"
"666","19-5012","Occupational Health and Safety Technicians","140",145,5,0.0357,0,4,6,10,"22.77",NA,"Central"
"667","21-0000","Community and Social Service Occupations","20102",23274,3172,0.1578,317,746,1387,2450,"23.34",NA,"Central"
"668","21-1012","Educational, Guidance, School, and Vocational Counselors","1820",2025,205,0.1126,20,63,114,197,"29.57",NA,"Central"
"669","21-1015","Rehabilitation Counselors","1637",2088,451,0.2755,45,61,110,216,"18.61",NA,"Central"
"670","21-1018","Substance Abuse, Behavioral Disorder, and Mental Health Counselors","1746",2184,438,0.2509,44,64,116,224,"23.47",NA,"Central"
"671","21-1021","Child, Family, and School Social Workers","1369",1630,261,0.1907,26,42,95,163,"23.24",NA,"Central"
"672","21-1022","Healthcare Social Workers","1476",1734,258,0.1748,26,45,101,172,"29.43",NA,"Central"
"673","21-1023","Mental Health and Substance Abuse Social Workers","1650",1951,301,0.1824,30,50,114,194,"23.41",NA,"Central"
"674","21-1029","Social Workers, All Other","600",641,41,0.0683,4,17,39,60,"28.54",NA,"Central"
"675","21-1091","Health Educators","567",644,77,0.1358,8,21,42,71,"29.29",NA,"Central"
"676","21-1092","Probation Officers and Correctional Treatment Specialists","695",748,53,0.0763,5,16,43,64,"23.68",NA,"Central"
"677","21-1093","Social and Human Service Assistants","3328",3962,634,0.1905,63,145,275,483,"18.04",NA,"Central"
"678","21-1094","Community Health Workers","403",510,107,0.2655,11,16,31,58,"17.809999999999999",NA,"Central"
"679","21-1099","Community and Social Service Specialists, All Other","511",546,35,0.0685,4,18,36,58,"28.97",NA,"Central"
"680","21-2011","Clergy","3259",3494,235,0.0721,24,138,195,357,"23.96",NA,"Central"
"681","23-0000","Legal Occupations","9952",10743,791,0.0795,79,278,389,746,"36.9",NA,"Central"
"682","23-1011","Lawyers","5900",6402,502,0.0851,50,133,151,334,"49.85",NA,"Central"
"683","23-1021","Administrative Law Judges, Adjudicators, and Hearing Officers","399",396,-3,-0.0075,0,9,10,19,"30.49",NA,"Central"
"684","23-1023","Judges, Magistrate Judges, and Magistrates","446",461,15,0.0336,2,10,11,23,"39.31",NA,"Central"
"685","23-2011","Paralegals and Legal Assistants","2504",2778,274,0.1094,27,102,178,307,"22.96",NA,"Central"
"686","23-2093","Title Examiners, Abstractors, and Searchers","458",451,-7,-0.0153,-1,16,27,42,"23.39",NA,"Central"
"687","23-2099","Legal Support Workers, All Other","152",155,3,0.0197,0,6,9,15,"28.73",NA,"Central"
"688","25-0000","Education, Training, and Library Occupations","64293",72346,8053,0.1253,805,2682,3084,6571,"29.28",NA,"Central"
"689","25-1011","Business Teachers, Postsecondary","410",413,3,0.0073,0,18,19,37,"100529","**","Central"
"690","25-1021","Computer Science Teachers, Postsecondary","181",183,2,0.011,0,8,8,16,"101107","**","Central"
"691","25-1022","Mathematical Science Teachers, Postsecondary","395",398,3,0.0076,0,18,18,36,"79334","**","Central"
"692","25-1042","Biological Science Teachers, Postsecondary","739",801,62,0.0839,6,34,36,76,"96617","**","Central"
"693","25-1052","Chemistry Teachers, Postsecondary","172",181,9,0.0523,1,8,8,17,"78995","**","Central"
"694","25-1054","Physics Teachers, Postsecondary","141",148,7,0.0496,1,6,7,14,"95912","**","Central"
"695","25-1065","Political Science Teachers, Postsecondary","102",107,5,0.049,0,5,5,10,"96815","**","Central"
"696","25-1066","Psychology Teachers, Postsecondary","293",307,14,0.0478,1,13,14,28,"81120","**","Central"
"697","25-1072","Nursing Instructors and Teachers, Postsecondary","446",506,60,0.1345,6,21,22,49,"80067","**","Central"
"698","25-1081","Education Teachers, Postsecondary","230",238,8,0.0348,1,10,11,22,"62849","**","Central"
"699","25-1111","Criminal Justice and Law Enforcement Teachers, Postsecondary","125",125,0,0,0,6,6,12,"75840","**","Central"
"700","25-1121","Art, Drama, and Music Teachers, Postsecondary","498",524,26,0.0522,3,23,24,50,"78725","**","Central"
"701","25-1122","Communications Teachers, Postsecondary","135",140,5,0.037,0,6,6,12,"79520","**","Central"
"702","25-1123","English Language and Literature Teachers, Postsecondary","402",405,3,0.0075,0,18,19,37,"75926","**","Central"
"703","25-1124","Foreign Language and Literature Teachers, Postsecondary","254",269,15,0.0591,2,12,12,26,"78575","**","Central"
"704","25-1125","History Teachers, Postsecondary","278",284,6,0.0216,1,13,13,27,"82650","**","Central"
"705","25-1126","Philosophy and Religion Teachers, Postsecondary","119",128,9,0.0756,1,6,6,13,"79898","**","Central"
"706","25-1193","Recreation and Fitness Studies Teachers, Postsecondary","115",117,2,0.0174,0,5,5,10,"79268","**","Central"
"707","25-1194","Vocational Education Teachers, Postsecondary","165",171,6,0.0364,1,8,8,17,"23.12",NA,"Central"
"708","25-2011","Preschool Teachers, Except Special Education","3789",5158,1369,0.3613,137,183,261,581,"13.96",NA,"Central"
"709","25-2012","Kindergarten Teachers, Except Special Education","469",513,44,0.0938,4,20,29,53,"63168","**","Central"
"710","25-2021","Elementary School Teachers, Except Special Education","10446",11401,955,0.0914,96,335,438,869,"76326","**","Central"
"711","25-2022","Middle School Teachers, Except Special and Career/Technical Education","5804",6335,531,0.0915,53,186,243,482,"63668","**","Central"
"712","25-2031","Secondary School Teachers, Except Special and Career/Technical Education","8843",9720,877,0.0992,88,246,376,710,"75328","**","Central"
"713","25-2032","Career/Technical Education Teachers, Secondary School","463",501,38,0.0821,4,13,20,37,"63698","**","Central"
"714","25-2052","Special Education Teachers, Kindergarten and Elementary School","1740",1905,165,0.0948,16,59,72,147,"76762","**","Central"
"715","25-2057","Special Education Teachers, Middle School","796",870,74,0.093,7,27,33,67,"61155","**","Central"
"716","25-2058","Special Education Teachers, Secondary School","1628",1820,192,0.1179,19,56,69,144,"62670","**","Central"
"717","25-3011","Adult Basic and Secondary Education and Literacy Teachers and Instructors","152",142,-10,-0.0658,-1,9,8,16,"29.51",NA,"Central"
"718","25-3021","Self-Enrichment Education Teachers","2341",3008,667,0.2849,67,160,143,370,"14.39",NA,"Central"
"719","25-3031","Substitute Teachers, Short-Term","1058",1241,183,0.173,18,69,62,149,"13.73",NA,"Central"
"720","25-3097","Teachers and Instructors, All Other, Except Substitute Teachers","1548",1805,257,0.166,26,100,90,216,"17.940000000000001","^^^","Central"
"721","25-4022","Librarians and Media Collections Specialists","1077",1162,85,0.0789,8,55,49,112,"28.87",NA,"Central"
"722","25-4031","Library Technicians","667",665,-2,-0.003,0,55,41,96,"18.13",NA,"Central"
"723","25-9031","Instructional Coordinators","1212",1338,126,0.104,13,63,56,132,"30.13",NA,"Central"
"724","25-9044","Teaching Assistants, Postsecondary","2843",2923,80,0.0281,8,129,135,272,"31547","**","Central"
"725","25-9045","Teaching Assistants, Except Postsecondary","7503",8674,1171,0.1561,117,362,378,857,"28845","**","Central"
"726","27-0000","Arts, Design, Entertainment, Sports, and Media Occupations","20406",22137,1731,0.0848,173,807,1336,2316,"23.76",NA,"Central"
"727","27-1011","Art Directors","549",561,12,0.0219,1,27,29,57,"42.39",NA,"Central"
"728","27-1014","Multimedia Artists and Animators","224",215,-9,-0.0402,-1,11,11,21,"26.39",NA,"Central"
"729","27-1021","Commercial and Industrial Designers","233",249,16,0.0687,2,7,14,23,"30.65",NA,"Central"
"730","27-1023","Floral Designers","297",245,-52,-0.1751,-5,8,16,19,"13.8",NA,"Central"
"731","27-1024","Graphic Designers","1822",1905,83,0.0456,8,57,111,176,"24.55",NA,"Central"
"732","27-1025","Interior Designers","739",768,29,0.0392,3,23,45,71,"27.99",NA,"Central"
"733","27-1026","Merchandise Displayers and Window Trimmers","1371",1431,60,0.0438,6,43,83,132,"14.56",NA,"Central"
"734","27-2012","Producers and Directors","727",674,-53,-0.0729,-5,15,44,54,"29.24",NA,"Central"
"735","27-2022","Coaches and Scouts","2849",3309,460,0.1615,46,175,248,469,"37777","**","Central"
"736","27-2041","Music Directors and Composers","388",422,34,0.0876,3,24,23,50,"32.869999999999997",NA,"Central"
"737","27-3011","Radio and Television Announcers","176",187,11,0.0625,1,7,10,18,"14.11",NA,"Central"
"738","27-3023","News Analysts, Reporters, and Journalists","423",394,-29,-0.0686,-3,12,31,40,"19.95",NA,"Central"
"739","27-3031","Public Relations Specialists","2782",3006,224,0.0805,22,72,190,284,"30.2",NA,"Central"
"740","27-3041","Editors","727",704,-23,-0.0316,-2,23,45,66,"30.16",NA,"Central"
"741","27-3042","Technical Writers","370",395,25,0.0676,2,10,24,36,"31.6",NA,"Central"
"742","27-3043","Writers and Authors","1093",1041,-52,-0.0476,-5,43,59,97,"24.16",NA,"Central"
"743","27-3091","Interpreters and Translators","2124",2861,737,0.347,74,97,136,307,"18.739999999999998",NA,"Central"
"744","27-4011","Audio and Video Equipment Technicians","269",313,44,0.1636,4,8,21,33,"23.35",NA,"Central"
"745","27-4012","Broadcast Technicians","135",134,-1,-0.0074,0,4,10,14,"23.03",NA,"Central"
"746","27-4021","Photographers","708",734,26,0.0367,3,24,40,67,"18.07",NA,"Central"
"747","29-0000","Healthcare Practitioners and Technical Occupations","70670",81227,10557,0.1494,1056,1962,2277,5295,"30.18",NA,"Central"
"748","29-1011","Chiropractors","387",447,60,0.155,6,6,3,15,"29.34",NA,"Central"
"749","29-1021","Dentists, General","741",831,90,0.1215,9,14,7,30,"80.680000000000007",NA,"Central"
"750","29-1031","Dietitians and Nutritionists","458",525,67,0.1463,7,16,17,40,"29.26",NA,"Central"
"751","29-1041","Optometrists","302",346,44,0.1457,4,6,4,14,"49.29",NA,"Central"
"752","29-1051","Pharmacists","2341",2393,52,0.0222,5,44,46,95,"61.71",NA,"Central"
"753","29-1071","Physician Assistants","706",946,240,0.3399,24,13,33,70,"49.27",NA,"Central"
"754","29-1122","Occupational Therapists","959",1157,198,0.2065,20,23,35,78,"39.159999999999997",NA,"Central"
"755","29-1123","Physical Therapists","1604",1954,350,0.2182,35,35,37,107,"47.76",NA,"Central"
"756","29-1125","Recreational Therapists","117",126,9,0.0769,1,4,5,10,"22.99",NA,"Central"
"757","29-1126","Respiratory Therapists","1057",1362,305,0.2886,30,26,30,86,"29.87",NA,"Central"
"758","29-1127","Speech-Language Pathologists","1257",1680,423,0.3365,42,34,53,129,"38.11",NA,"Central"
"759","29-1128","Exercise Physiologists","188",219,31,0.1649,3,6,7,16,"17.8",NA,"Central"
"760","29-1129","Therapists, All Other","907",1012,105,0.1158,10,29,33,72,"36.159999999999997",NA,"Central"
"761","29-1131","Veterinarians","800",939,139,0.1738,14,14,14,42,"47.83",NA,"Central"
"762","29-1141","Registered Nurses","26388",30284,3896,0.1476,390,756,713,1859,"36.08",NA,"Central"
"763","29-1151","Nurse Anesthetists","645",759,114,0.1767,11,14,21,46,"81.39",NA,"Central"
"764","29-1171","Nurse Practitioners","1771",2717,946,0.5342,95,47,70,212,"49.63",NA,"Central"
"765","29-1211","Anesthesiologists","363",381,18,0.0496,2,6,4,12,"#",NA,"Central"
"766","29-1215","Family Medicine Physicians","333",365,32,0.0961,3,6,4,13,"86.13",NA,"Central"
"767","29-1216","General Internal Medicine Physicians","506",521,15,0.0296,2,8,6,16,"85.12",NA,"Central"
"768","29-1218","Obstetricians and Gynecologists","210",210,0,0,0,3,2,5,"81.569999999999993",NA,"Central"
"769","29-1223","Psychiatrists","108",128,20,0.1852,2,2,1,5,"#",NA,"Central"
"770","29-1228","Physicians, All Other; and Ophthalmologists, Except Pediatric","2142",2359,217,0.1013,22,36,25,83,"37.450000000000003","^^^","Central"
"771","29-1248","Surgeons, Except Ophthalmologists","396",400,4,0.0101,0,6,4,10,"# ^^^",NA,"Central"
"772","29-1292","Dental Hygienists","1261",1449,188,0.1491,19,49,34,102,"37.130000000000003",NA,"Central"
"773","29-1298","Acupuncturists and Healthcare Diagnosing or Treating Practitioners, All Other","155",167,12,0.0774,1,7,2,10,"37.450000000000003","^^^","Central"
"774","29-2010","Clinical Laboratory Technologists and Technicians","2440",2721,281,0.1152,28,67,96,191,"23.91",NA,"Central"
"775","29-2031","Cardiovascular Technologists and Technicians","291",330,39,0.134,4,8,13,25,"29.9",NA,"Central"
"776","29-2032","Diagnostic Medical Sonographers","435",539,104,0.2391,10,13,21,44,"31.03",NA,"Central"
"777","29-2033","Nuclear Medicine Technologists","140",156,16,0.1143,2,4,6,12,"37.54",NA,"Central"
"778","29-2034","Radiologic Technologists","1647",1870,223,0.1354,22,48,76,146,"28.74",NA,"Central"
"779","29-2035","Magnetic Resonance Imaging Technologists","200",220,20,0.1,2,6,9,17,"37.17",NA,"Central"
"780","29-2040","Emergency Medical Technicians and Paramedics","939",1013,74,0.0788,7,18,45,70,"17.760000000000002","^","Central"
"781","29-2051","Dietetic Technicians","186",212,26,0.1398,3,5,9,17,"17.579999999999998",NA,"Central"
"782","29-2052","Pharmacy Technicians","3103",3225,122,0.0393,12,86,136,234,"17.62",NA,"Central"
"783","29-2053","Psychiatric Technicians","400",498,98,0.245,10,12,19,41,"14.26",NA,"Central"
"784","29-2055","Surgical Technologists","786",898,112,0.1425,11,23,36,70,"23.15",NA,"Central"
"785","29-2056","Veterinary Technologists and Technicians","1023",1176,153,0.1496,15,30,47,92,"17.510000000000002",NA,"Central"
"786","29-2057","Ophthalmic Medical Technicians","559",679,120,0.2147,12,17,27,56,"17.62",NA,"Central"
"787","29-2061","Licensed Practical and Licensed Vocational Nurses","7184",8219,1035,0.1441,104,260,322,686,"22.95",NA,"Central"
"788","29-2081","Opticians, Dispensing","748",802,54,0.0722,5,32,26,63,"21.77",NA,"Central"
"789","29-2091","Orthotists and Prosthetists","151",182,31,0.2053,3,4,7,14,"29.34",NA,"Central"
"790","29-2098","Medical Dosimetrists, Medical Records Specialists, and Health Technologists and Technicians, All Other","2583",2872,289,0.1119,29,74,117,220,"22.55","^^^","Central"
"791","29-9098","Health Information Technologists, Medical Registrars, Surgical Assistants, & Healthcare Practitioners, AO","441",468,27,0.0612,3,12,20,35,"26.19","^^^","Central"
"792","31-0000","Healthcare Support Occupations","47611",60146,12535,0.2633,1254,3188,3297,7739,"14.21",NA,"Central"
"793","31-1120","Home Health and Personal Care Aides","23796",32404,8608,0.3617,861,1799,1591,4251,"11.54",NA,"Central"
"794","31-1131","Nursing Assistants","10398",11555,1157,0.1113,116,703,622,1441,"14.44",NA,"Central"
"795","31-1132","Orderlies","411",468,57,0.1387,6,28,25,59,"14.14",NA,"Central"
"796","31-1133","Psychiatric Aides","179",202,23,0.1285,2,12,11,25,"18.34",NA,"Central"
"797","31-2011","Occupational Therapy Assistants","500",704,204,0.408,20,30,44,94,"29.98",NA,"Central"
"798","31-2021","Physical Therapist Assistants","985",1313,328,0.333,33,49,87,169,"30.08",NA,"Central"
"799","31-9011","Massage Therapists","971",1200,229,0.2358,23,64,57,144,"23.15",NA,"Central"
"800","31-9091","Dental Assistants","2247",2594,347,0.1544,35,110,170,315,"22.58",NA,"Central"
"801","31-9092","Medical Assistants","5146",6326,1180,0.2293,118,235,429,782,"17.96",NA,"Central"
"802","31-9093","Medical Equipment Preparers","549",630,81,0.1475,8,33,39,80,"18.23",NA,"Central"
"803","31-9094","Medical Transcriptionists","132",111,-21,-0.1591,-2,6,10,14,"18.37",NA,"Central"
"804","31-9096","Veterinary Assistants and Laboratory Animal Caretakers","892",1039,147,0.1648,15,47,107,169,"14.27",NA,"Central"
"805","31-9097","Phlebotomists","683",811,128,0.1874,13,32,54,99,"17.850000000000001",NA,"Central"
"806","31-9099","Healthcare Support Workers, All Other","478",518,40,0.0837,4,28,33,65,"18.3",NA,"Central"
"807","33-0000","Protective Service Occupations","22769",25010,2241,0.0984,224,1070,1506,2800,"23.04",NA,"Central"
"808","33-1011","First-Line Supervisors of Correctional Officers","106",104,-2,-0.0189,0,3,5,8,"37.659999999999997",NA,"Central"
"809","33-1021","First-Line Supervisors of Fire Fighting and Prevention Workers","566",624,58,0.1025,6,14,24,44,"39.119999999999997",NA,"Central"
"810","33-1090","Miscellaneous First-Line Supervisors, Protective Service Workers","614",704,90,0.1466,9,24,38,71,"25.23","^","Central"
"811","33-2011","Firefighters","3540",3918,378,0.1068,38,82,192,312,"29.01",NA,"Central"
"812","33-3011","Bailiffs","253",266,13,0.0514,1,10,14,25,"22.96",NA,"Central"
"813","33-3012","Correctional Officers and Jailers","3122",2818,-304,-0.0974,-30,112,161,243,"23.04",NA,"Central"
"814","33-3021","Detectives and Criminal Investigators","569",575,6,0.0105,1,15,26,42,"37.659999999999997",NA,"Central"
"815","33-3051","Police and Sheriff's Patrol Officers","4694",5126,432,0.092,43,123,249,415,"37.21",NA,"Central"
"816","33-9021","Private Detectives and Investigators","135",133,-2,-0.0148,0,4,8,12,"23.94",NA,"Central"
"817","33-9032","Security Guards","6277",7350,1073,0.1709,107,361,528,996,"14.14",NA,"Central"
"818","33-9092","Lifeguards, Ski Patrol, and Other Recreational Protective Service Workers","839",1078,239,0.2849,24,132,106,262,"10.84",NA,"Central"
"819","33-9093","Transportation Security Screeners","310",324,14,0.0452,1,11,16,28,"22.3",NA,"Central"
"820","33-9098","School Bus Monitors and Protective Service Workers, All Other","680",823,143,0.2103,14,104,83,201,"15.11","^^^","Central"
"821","35-0000","Food Preparation and Serving Related Occupations","84443",96042,11599,0.1374,1160,6822,9254,17236,"11.24",NA,"Central"
"822","35-1011","Chefs and Head Cooks","564",670,106,0.1879,11,18,60,89,"24.91",NA,"Central"
"823","35-1012","First-Line Supervisors of Food Preparation and Serving Workers","8959",10481,1522,0.1699,152,434,991,1577,"17.47",NA,"Central"
"824","35-2011","Cooks, Fast Food","4166",3878,-288,-0.0691,-29,237,344,552,"11.35",NA,"Central"
"825","35-2012","Cooks, Institution and Cafeteria","3661",3983,322,0.088,32,225,327,584,"14.34",NA,"Central"
"826","35-2014","Cooks, Restaurant","6119",8625,2506,0.4095,251,434,631,1316,"14.09",NA,"Central"
"827","35-2015","Cooks, Short Order","1019",1091,72,0.0707,7,62,90,159,"12.47",NA,"Central"
"828","35-2021","Food Preparation Workers","5264",5391,127,0.0241,13,418,490,921,"12.07",NA,"Central"
"829","35-3011","Bartenders","3393",4354,961,0.2832,96,176,469,741,"10.199999999999999",NA,"Central"
"830","35-3023","Fast Food and Counter Workers","27269",29969,2700,0.099,270,2775,3026,6071,"10.78",NA,"Central"
"831","35-3031","Waiters and Waitresses","15688",17969,2281,0.1454,228,1236,2010,3474,"10.039999999999999",NA,"Central"
"832","35-3041","Food Servers, Nonrestaurant","1947",2163,216,0.1109,22,163,160,345,"12.8",NA,"Central"
"833","35-9011","Dining Room and Cafeteria Attendants and Bartender Helpers","1329",1636,307,0.231,31,128,128,287,"11.18",NA,"Central"
"834","35-9021","Dishwashers","2160",2446,286,0.1324,29,173,193,395,"11.15",NA,"Central"
"835","35-9031","Hosts and Hostesses, Restaurant, Lounge, and Coffee Shop","2226",2621,395,0.1774,40,287,273,600,"10.96",NA,"Central"
"836","35-9099","Food Preparation and Serving Related Workers, All Other","476",585,109,0.229,11,46,46,103,"11.42",NA,"Central"
"837","37-0000","Building and Grounds Cleaning and Maintenance Occupations","36160",37855,1695,0.0469,170,2087,2711,4968,"14.41",NA,"Central"
"838","37-1011","First-Line Supervisors of Housekeeping and Janitorial Workers","1589",1614,25,0.0157,2,69,111,182,"19.46",NA,"Central"
"839","37-1012","First-Line Supervisors of Landscaping, Lawn Service, and Groundskeeping Workers","1226",1252,26,0.0212,3,38,89,130,"23.33",NA,"Central"
"840","37-2011","Janitors and Cleaners, Except Maids and Housekeeping Cleaners","17091",17801,710,0.0415,71,1089,1223,2383,"14.15",NA,"Central"
"841","37-2012","Maids and Housekeeping Cleaners","6937",7355,418,0.0603,42,485,460,987,"13.1",NA,"Central"
"842","37-3011","Landscaping and Groundskeeping Workers","8602",9087,485,0.0564,48,380,758,1186,"14.79",NA,"Central"
"843","39-0000","Personal Care and Service Occupations","23381",27817,4436,0.1897,444,1645,2018,4107,"12.57",NA,"Central"
"844","39-2011","Animal Trainers","125",161,36,0.288,4,7,10,21,"14.32",NA,"Central"
"845","39-2021","Nonfarm Animal Caretakers","1619",2286,667,0.412,67,125,162,354,"11.09",NA,"Central"
"846","39-3031","Ushers, Lobby Attendants, and Ticket Takers","608",966,358,0.5888,36,100,80,216,"11.5",NA,"Central"
"847","39-3091","Amusement and Recreation Attendants","1808",2352,544,0.3009,54,203,233,490,"10.72",NA,"Central"
"848","39-3093","Locker Room, Coatroom, and Dressing Room Attendants","111",137,26,0.2342,3,12,14,29,"14.05",NA,"Central"
"849","39-5012","Hairdressers, Hairstylists, and Cosmetologists","4186",4231,45,0.0108,4,223,234,461,"13.98",NA,"Central"
"850","39-5094","Skincare Specialists","344",390,46,0.1337,5,19,19,43,"18.05",NA,"Central"
"851","39-7010","Tour and Travel Guides","105",133,28,0.2667,3,8,11,22,"22.66",NA,"Central"
"852","39-9011","Childcare Workers","6523",7352,829,0.1271,83,467,485,1035,"11.28",NA,"Central"
"853","39-9031","Fitness Trainers and Aerobics Instructors","2137",2992,855,0.4001,86,150,243,479,"15.34",NA,"Central"
"854","39-9032","Recreation Workers","2653",3105,452,0.1704,45,169,273,487,"11.12",NA,"Central"
"855","41-0000","Sales and Related Occupations","95111",93524,-1587,-0.0167,-159,4582,7305,11728,"14.27",NA,"Central"
"856","41-1011","First-Line Supervisors of Retail Sales Workers","8325",7771,-554,-0.0665,-55,284,558,787,"18.77",NA,"Central"
"857","41-1012","First-Line Supervisors of Non-Retail Sales Workers","2771",2583,-188,-0.0678,-19,78,159,218,"38.090000000000003",NA,"Central"
"858","41-2011","Cashiers","17377",15429,-1948,-0.1121,-195,1395,1570,2770,"11.04",NA,"Central"
"859","41-2021","Counter and Rental Clerks","2044",2192,148,0.0724,15,95,145,255,"14.27",NA,"Central"
"860","41-2031","Retail Salespersons","27404",27038,-366,-0.0134,-37,1522,2248,3733,"13.41",NA,"Central"
"861","41-3011","Advertising Sales Agents","802",731,-71,-0.0885,-7,23,71,87,"24.04",NA,"Central"
"862","41-3021","Insurance Sales Agents","4264",4703,439,0.103,44,149,251,444,"29.02",NA,"Central"
"863","41-3031","Securities, Commodities, and Financial Services Sales Agents","4118",4448,330,0.0801,33,95,270,398,"37.24",NA,"Central"
"864","41-3041","Travel Agents","289",258,-31,-0.1073,-3,13,18,28,"18.57",NA,"Central"
"865","41-3091","Sales Representatives of Services, Except Advertising, Insurance, Financial Services, and Travel","7782",8207,425,0.0546,42,201,703,946,"27.83",NA,"Central"
"866","41-4011","Sales Representatives, Wholesale and Manufacturing, Technical and Scientific Products","1775",1836,61,0.0344,6,53,122,181,"48.42",NA,"Central"
"867","41-4012","Sales Representatives, Wholesale and Manufacturing, Except Technical and Scientific Products","9583",9798,215,0.0224,22,286,655,963,"30",NA,"Central"
"868","41-9011","Demonstrators and Product Promoters","180",199,19,0.1056,2,21,12,35,"14.8",NA,"Central"
"869","41-9022","Real Estate Sales Agents","3917",4088,171,0.0437,17,166,176,359,"17.739999999999998",NA,"Central"
"870","41-9031","Sales Engineers","292",298,6,0.0205,1,6,24,31,"47.92",NA,"Central"
"871","41-9041","Telemarketers","1125",894,-231,-0.2053,-23,47,103,127,"13.61",NA,"Central"
"872","41-9099","Sales and Related Workers, All Other","779",797,18,0.0231,2,36,65,103,"13.73",NA,"Central"
"873","43-0000","Office and Administrative Support Occupations","158231",156256,-1975,-0.0125,-198,7404,9929,17135,"18.3",NA,"Central"
"874","43-1011","First-Line Supervisors of Office and Administrative Support Workers","10833",10894,61,0.0056,6,403,664,1073,"29.28",NA,"Central"
"875","43-2011","Switchboard Operators, Including Answering Service","492",370,-122,-0.248,-12,22,25,35,"14.33",NA,"Central"
"876","43-3011","Bill and Account Collectors","2309",2040,-269,-0.1165,-27,80,154,207,"18.13",NA,"Central"
"877","43-3021","Billing and Posting Clerks","4373",4677,304,0.0695,30,186,278,494,"18.329999999999998",NA,"Central"
"878","43-3031","Bookkeeping, Accounting, and Auditing Clerks","11986",11676,-310,-0.0259,-31,693,604,1266,"21.51",NA,"Central"
"879","43-3051","Payroll and Timekeeping Clerks","822",729,-93,-0.1131,-9,37,42,70,"22.78",NA,"Central"
"880","43-3071","Tellers","2700",2363,-337,-0.1248,-34,103,159,228,"14.65",NA,"Central"
"881","43-3099","Financial Clerks, All Other","752",796,44,0.0585,4,27,55,86,"23.01",NA,"Central"
"882","43-4011","Brokerage Clerks","535",515,-20,-0.0374,-2,21,35,54,"23.42",NA,"Central"
"883","43-4021","Correspondence Clerks","165",156,-9,-0.0545,-1,7,10,16,"18.13",NA,"Central"
"884","43-4031","Court, Municipal, and License Clerks","1631",1806,175,0.1073,18,84,86,188,"22.28",NA,"Central"
"885","43-4041","Credit Authorizers, Checkers, and Clerks","186",179,-7,-0.0376,-1,6,11,16,"23.1",NA,"Central"
"886","43-4051","Customer Service Representatives","33376",32929,-447,-0.0134,-45,1558,2607,4120,"18",NA,"Central"
"887","43-4061","Eligibility Interviewers, Government Programs","1051",1109,58,0.0552,6,40,56,102,"22.92",NA,"Central"
"888","43-4071","File Clerks","843",736,-107,-0.1269,-11,43,49,81,"17.91",NA,"Central"
"889","43-4081","Hotel, Motel, and Resort Desk Clerks","812",921,109,0.1342,11,50,92,153,"11.41",NA,"Central"
"890","43-4111","Interviewers, Except Eligibility and Loan","849",842,-7,-0.0082,-1,49,55,103,"17.920000000000002",NA,"Central"
"891","43-4121","Library Assistants, Clerical","924",918,-6,-0.0065,-1,82,59,140,"14.27",NA,"Central"
"892","43-4131","Loan Interviewers and Clerks","2148",2129,-19,-0.0088,-2,62,126,186,"22.55",NA,"Central"
"893","43-4151","Order Clerks","977",766,-211,-0.216,-21,37,55,71,"17.95",NA,"Central"
"894","43-4161","Human Resources Assistants, Except Payroll and Timekeeping","1486",1457,-29,-0.0195,-3,56,89,142,"18.8",NA,"Central"
"895","43-4171","Receptionists and Information Clerks","7289",7833,544,0.0746,54,422,522,998,"14.23",NA,"Central"
"896","43-4199","Information and Record Clerks, All Other","509",537,28,0.055,3,21,34,58,"22.26",NA,"Central"
"897","43-5011","Cargo and Freight Agents","313",348,35,0.1118,4,13,20,37,"22.44",NA,"Central"
"898","43-5021","Couriers and Messengers","582",548,-34,-0.0584,-3,23,31,51,"14.71",NA,"Central"
"899","43-5031","Police, Fire, and Ambulance Dispatchers","644",697,53,0.0823,5,24,38,67,"23.25",NA,"Central"
"900","43-5032","Dispatchers, Except Police, Fire, and Ambulance","1110",1195,85,0.0766,8,41,65,114,"19.350000000000001",NA,"Central"
"901","43-5041","Meter Readers, Utilities","398",361,-37,-0.093,-4,11,17,24,"23.05",NA,"Central"
"902","43-5051","Postal Service Clerks","433",399,-34,-0.0785,-3,19,15,31,"24.16",NA,"Central"
"903","43-5052","Postal Service Mail Carriers","1966",1810,-156,-0.0793,-16,66,68,118,"25.21",NA,"Central"
"904","43-5053","Postal Service Mail Sorters, Processors, and Processing Machine Operators","840",736,-104,-0.1238,-10,43,26,59,"22.25",NA,"Central"
"905","43-5061","Production, Planning, and Expediting Clerks","3921",4183,262,0.0668,26,145,263,434,"23.2",NA,"Central"
"906","43-5071","Shipping, Receiving, and Traffic Clerks","8470",8234,-236,-0.0279,-24,305,491,772,"17.91",NA,"Central"
"907","43-5111","Weighers, Measurers, Checkers, and Samplers, Recordkeeping","340",395,55,0.1618,6,14,21,41,"19.22",NA,"Central"
"908","43-6011","Executive Secretaries and Executive Administrative Assistants","4395",3477,-918,-0.2089,-92,200,220,328,"29.42",NA,"Central"
"909","43-6012","Legal Secretaries","1211",945,-266,-0.2197,-27,55,60,88,"22.89",NA,"Central"
"910","43-6013","Medical Secretaries","6915",7922,1007,0.1456,101,378,414,893,"17.93",NA,"Central"
"911","43-6014","Secretaries and Administrative Assistants, Except Legal, Medical, and Executive","10974",10311,-663,-0.0604,-66,542,594,1070,"18.29",NA,"Central"
"912","43-9021","Data Entry Keyers","1043",793,-250,-0.2397,-25,41,58,74,"18.07",NA,"Central"
"913","43-9022","Word Processors and Typists","198",127,-71,-0.3586,-7,10,9,12,"18.079999999999998",NA,"Central"
"914","43-9041","Insurance Claims and Policy Processing Clerks","2839",2899,60,0.0211,6,101,168,275,"22.82",NA,"Central"
"915","43-9051","Mail Clerks and Mail Machine Operators, Except Postal Service","936",895,-41,-0.0438,-4,46,57,99,"15.05",NA,"Central"
"916","43-9061","Office Clerks, General","19984",19864,-120,-0.006,-12,1087,1182,2257,"18.13",NA,"Central"
"917","43-9071","Office Machine Operators, Except Computer","1126",965,-161,-0.143,-16,54,63,101,"17.95",NA,"Central"
"918","43-9199","Office and Administrative Support Workers, All Other","877",950,73,0.0832,7,38,63,108,"22.44",NA,"Central"
"919","45-0000","Farming, Fishing, and Forestry Occupations","2208",2276,68,0.0308,7,94,254,355,"15.06",NA,"Central"
"920","45-1011","First-Line Supervisors of Farming, Fishing, and Forestry Workers","160",167,7,0.0438,1,6,17,24,"30.4",NA,"Central"
"921","45-2091","Agricultural Equipment Operators","244",266,22,0.0902,2,11,29,42,"22.04",NA,"Central"
"922","45-2092","Farmworkers and Laborers, Crop, Nursery, and Greenhouse","1308",1361,53,0.0405,5,56,152,213,"15",NA,"Central"
"923","45-2093","Farmworkers, Farm, Ranch, and Aquacultural Animals","273",258,-15,-0.0549,-2,11,30,39,"14.3",NA,"Central"
"924","47-0000","Construction and Extraction Occupations","38627",41371,2744,0.071,274,1188,2738,4200,"23.97",NA,"Central"
"925","47-1011","First-Line Supervisors of Construction Trades and Extraction Workers","3465",3724,259,0.0747,26,102,233,361,"31.67",NA,"Central"
"926","47-2021","Brickmasons and Blockmasons","365",356,-9,-0.0247,-1,12,22,33,"29.77",NA,"Central"
"927","47-2031","Carpenters","4186",4353,167,0.0399,17,125,266,408,"23.43",NA,"Central"
"928","47-2044","Tile and Marble Setters","264",291,27,0.1023,3,7,16,26,"22.47",NA,"Central"
"929","47-2051","Cement Masons and Concrete Finishers","1399",1411,12,0.0086,1,34,92,127,"23.41",NA,"Central"
"930","47-2061","Construction Laborers","8667",9456,789,0.091,79,268,612,959,"22.61",NA,"Central"
"931","47-2071","Paving, Surfacing, and Tamping Equipment Operators","373",410,37,0.0992,4,13,28,45,"23.1",NA,"Central"
"932","47-2073","Operating Engineers and Other Construction Equipment Operators","2553",2759,206,0.0807,21,87,190,298,"29.09",NA,"Central"
"933","47-2111","Electricians","6083",6728,645,0.106,64,186,470,720,"28.55",NA,"Central"
"934","47-2121","Glaziers","260",271,11,0.0423,1,7,20,28,"23.48",NA,"Central"
"935","47-2141","Painters, Construction and Maintenance","1326",1403,77,0.0581,8,41,76,125,"22.54",NA,"Central"
"936","47-2151","Pipelayers","161",170,9,0.0559,1,5,12,18,"22.61",NA,"Central"
"937","47-2152","Plumbers, Pipefitters, and Steamfitters","2585",2751,166,0.0642,17,78,192,287,"29.77",NA,"Central"
"938","47-2181","Roofers","948",1001,53,0.0559,5,24,68,97,"23.02",NA,"Central"
"939","47-2211","Sheet Metal Workers","479",497,18,0.0376,2,13,32,47,"28.69",NA,"Central"
"940","47-2221","Structural Iron and Steel Workers","446",472,26,0.0583,3,12,35,50,"29.09",NA,"Central"
"941","47-3011","Helpers--Brickmasons, Blockmasons, Stonemasons, and Tile and Marble Setters","115",117,2,0.0174,0,3,10,13,"22.61",NA,"Central"
"942","47-3013","Helpers--Electricians","486",494,8,0.0165,1,14,43,58,"14.77",NA,"Central"
"943","47-3015","Helpers--Pipelayers, Plumbers, Pipefitters, and Steamfitters","233",250,17,0.073,2,7,21,30,"14.03",NA,"Central"
"944","47-4011","Construction and Building Inspectors","738",679,-59,-0.0799,-6,38,43,75,"29.63",NA,"Central"
"945","47-4041","Hazardous Materials Removal Workers","469",499,30,0.064,3,18,39,60,"22.89",NA,"Central"
"946","47-4051","Highway Maintenance Workers","712",772,60,0.0843,6,29,47,82,"22.61",NA,"Central"
"947","47-4071","Septic Tank Servicers and Sewer Pipe Cleaners","174",208,34,0.1954,3,6,16,25,"23.31",NA,"Central"
"948","47-4090","Miscellaneous Construction and Related Workers","212",246,34,0.1604,3,7,19,29,"18.12",NA,"Central"
"949","47-5022","Excavating and Loading Machine and Dragline Operators, Surface Mining","109",118,9,0.0826,1,4,10,15,"19.059999999999999",NA,"Central"
"950","49-0000","Installation, Maintenance, and Repair Occupations","43950",47440,3490,0.0794,349,1429,2879,4657,"23.21",NA,"Central"
"951","49-1011","First-Line Supervisors of Mechanics, Installers, and Repairers","3741",4050,309,0.0826,31,113,232,376,"31.22",NA,"Central"
"952","49-2011","Computer, Automated Teller, and Office Machine Repairers","680",669,-11,-0.0162,-1,20,51,70,"18.88",NA,"Central"
"953","49-2022","Telecommunications Equipment Installers and Repairers, Except Line Installers","1513",1467,-46,-0.0304,-5,52,114,161,"29.2",NA,"Central"
"954","49-2094","Electrical and Electronics Repairers, Commercial and Industrial Equipment","480",539,59,0.1229,6,14,25,45,"29.76",NA,"Central"
"955","49-2097","Electronic Home Entertainment Equipment Installers and Repairers","106",120,14,0.1321,1,4,8,13,"22.22",NA,"Central"
"956","49-2098","Security and Fire Alarm Systems Installers","567",697,130,0.2293,13,15,49,77,"23.07",NA,"Central"
"957","49-3021","Automotive Body and Related Repairers","1173",1237,64,0.0546,6,38,72,116,"22.69",NA,"Central"
"958","49-3023","Automotive Service Technicians and Mechanics","5571",5626,55,0.0099,6,166,380,552,"21.76",NA,"Central"
"959","49-3031","Bus and Truck Mechanics and Diesel Engine Specialists","1708",1874,166,0.0972,17,51,112,180,"23.6",NA,"Central"
"960","49-3041","Farm Equipment Mechanics and Service Technicians","226",235,9,0.0398,1,7,16,24,"21.16",NA,"Central"
"961","49-3042","Mobile Heavy Equipment Mechanics, Except Engines","646",708,62,0.096,6,20,46,72,"28.72",NA,"Central"
"962","49-3093","Tire Repairers and Changers","721",740,19,0.0264,2,22,61,85,"14.68",NA,"Central"
"963","49-9011","Mechanical Door Repairers","105",133,28,0.2667,3,3,7,13,"22.43",NA,"Central"
"964","49-9012","Control and Valve Installers and Repairers, Except Mechanical Door","224",225,1,0.0045,0,5,13,18,"38.18",NA,"Central"
"965","49-9021","Heating, Air Conditioning, and Refrigeration Mechanics and Installers","3204",3422,218,0.068,22,85,226,333,"23.96",NA,"Central"
"966","49-9031","Home Appliance Repairers","215",219,4,0.0186,0,8,13,21,"22.79",NA,"Central"
"967","49-9041","Industrial Machinery Mechanics","3134",3821,687,0.2192,69,107,188,364,"29.02",NA,"Central"
"968","49-9043","Maintenance Workers, Machinery","451",521,70,0.1552,7,16,27,50,"24.34",NA,"Central"
"969","49-9044","Millwrights","482",556,74,0.1535,7,15,30,52,"34.74",NA,"Central"
"970","49-9051","Electrical Power-Line Installers and Repairers","1027",1033,6,0.0058,1,19,69,89,"38.58",NA,"Central"
"971","49-9052","Telecommunications Line Installers and Repairers","741",751,10,0.0135,1,17,63,81,"23.04",NA,"Central"
"972","49-9062","Medical Equipment Repairers","656",735,79,0.1204,8,30,42,80,"29.02",NA,"Central"
"973","49-9071","Maintenance and Repair Workers, General","11108",12239,1131,0.1018,113,411,681,1205,"22.55",NA,"Central"
"974","49-9091","Coin, Vending, and Amusement Machine Servicers and Repairers","191",199,8,0.0419,1,9,14,24,"18.23",NA,"Central"
"975","49-9098","Helpers--Installation, Maintenance, and Repair Workers","332",360,28,0.0843,3,15,29,47,"17.72",NA,"Central"
"976","49-9099","Installation, Maintenance, and Repair Workers, All Other","959",1045,86,0.0897,9,35,67,111,"18.62",NA,"Central"
"977","51-0000","Production Occupations","64640",64837,197,0.003,20,2447,4612,7079,"18.23",NA,"Central"
"978","51-1011","First-Line Supervisors of Production and Operating Workers","3994",4179,185,0.0463,18,123,275,416,"29.58",NA,"Central"
"979","51-2028","Electrical, Electronic, and Electromechanical Assemblers, Except Coil Winders, Tapers, and Finishers","1431",1538,107,0.0748,11,60,95,166,"18.05",NA,"Central"
"980","51-2041","Structural Metal Fabricators and Fitters","295",256,-39,-0.1322,-4,6,22,24,"22.55",NA,"Central"
"981","51-2090","Miscellaneous Assemblers and Fabricators","16599",16443,-156,-0.0094,-16,630,1179,1793,"17.78",NA,"Central"
"982","51-3011","Bakers","1174",1269,95,0.0809,10,68,91,169,"14.31",NA,"Central"
"983","51-3021","Butchers and Meat Cutters","649",607,-42,-0.0647,-4,26,47,69,"14.56",NA,"Central"
"984","51-3022","Meat, Poultry, and Fish Cutters and Trimmers","171",170,-1,-0.0058,0,7,13,20,"14.46",NA,"Central"
"985","51-3092","Food Batchmakers","895",879,-16,-0.0179,-2,41,66,105,"14.43",NA,"Central"
"986","51-3099","Food Processing Workers, All Other","126",118,-8,-0.0635,-1,4,8,11,"14.13",NA,"Central"
"987","51-4021","Extruding and Drawing Machine Setters, Operators, and Tenders, Metal and Plastic","660",603,-57,-0.0864,-6,22,39,55,"18.32",NA,"Central"
"988","51-4022","Forging Machine Setters, Operators, and Tenders, Metal and Plastic","140",123,-17,-0.1214,-2,5,8,11,"18.23",NA,"Central"
"989","51-4031","Cutting, Punching, and Press Machine Setters, Operators, and Tenders, Metal and Plastic","1299",1278,-21,-0.0162,-2,41,89,128,"18.09",NA,"Central"
"990","51-4033","Grinding, Lapping, Polishing, and Buffing Machine Tool Setters, Operators, and Tenders, Metal and Plastic","220",205,-15,-0.0682,-2,10,15,23,"17.420000000000002",NA,"Central"
"991","51-4034","Lathe and Turning Machine Tool Setters, Operators, and Tenders, Metal and Plastic","146",141,-5,-0.0342,0,5,10,15,"23.05",NA,"Central"
"992","51-4041","Machinists","1314",1388,74,0.0563,7,45,92,144,"19.18",NA,"Central"
"993","51-4072","Molding, Coremaking, and Casting Machine Setters, Operators, and Tenders, Metal and Plastic","1327",1257,-70,-0.0528,-7,42,88,123,"15.37",NA,"Central"
"994","51-4081","Multiple Machine Tool Setters, Operators, and Tenders, Metal and Plastic","1289",1401,112,0.0869,11,44,91,146,"19.32",NA,"Central"
"995","51-4111","Tool and Die Makers","623",644,21,0.0337,2,23,40,65,"29.22",NA,"Central"
"996","51-4121","Welders, Cutters, Solderers, and Brazers","2296",2495,199,0.0867,20,63,189,272,"22.44",NA,"Central"
"997","51-4122","Welding, Soldering, and Brazing Machine Setters, Operators, and Tenders","172",181,9,0.0523,1,5,14,20,"21.8",NA,"Central"
"998","51-4193","Plating and Coating Machine Setters, Operators, and Tenders, Metal and Plastic","195",192,-3,-0.0154,0,6,13,19,"17.62",NA,"Central"
"999","51-5111","Prepress Technicians and Workers","207",186,-21,-0.1014,-2,7,19,24,"21.93",NA,"Central"
"1000","51-5112","Printing Press Operators","1501",1427,-74,-0.0493,-7,53,103,149,"18.62",NA,"Central"
"1001","51-5113","Print Binding and Finishing Workers","305",259,-46,-0.1508,-5,14,18,27,"14.61",NA,"Central"
"1002","51-6011","Laundry and Dry-Cleaning Workers","1159",1336,177,0.1527,18,81,84,183,"11.5",NA,"Central"
"1003","51-6031","Sewing Machine Operators","618",621,3,0.0049,0,38,33,71,"14.7",NA,"Central"
"1004","51-7011","Cabinetmakers and Bench Carpenters","531",574,43,0.081,4,21,31,56,"18.36",NA,"Central"
"1005","51-7042","Woodworking Machine Setters, Operators, and Tenders, Except Sawing","462",515,53,0.1147,5,14,35,54,"16.91",NA,"Central"
"1006","51-8021","Stationary Engineers and Boiler Operators","112",115,3,0.0268,0,6,8,14,"30.07",NA,"Central"
"1007","51-8031","Water and Wastewater Treatment Plant and System Operators","621",637,16,0.0258,2,18,39,59,"23.53",NA,"Central"
"1008","51-9011","Chemical Equipment Operators and Tenders","524",483,-41,-0.0782,-4,11,39,46,"23.42",NA,"Central"
"1009","51-9012","Separating, Filtering, Clarifying, Precipitating, and Still Machine Setters, Operators, and Tenders","524",515,-9,-0.0172,-1,11,40,50,"19.079999999999998",NA,"Central"
"1010","51-9023","Mixing and Blending Machine Setters, Operators, and Tenders","1354",1419,65,0.048,6,47,104,157,"19.03",NA,"Central"
"1011","51-9032","Cutting and Slicing Machine Setters, Operators, and Tenders","466",453,-13,-0.0279,-1,21,35,55,"18.11",NA,"Central"
"1012","51-9041","Extruding, Forming, Pressing, and Compacting Machine Setters, Operators, and Tenders","657",668,11,0.0167,1,18,49,68,"18.45",NA,"Central"
"1013","51-9061","Inspectors, Testers, Sorters, Samplers, and Weighers","4103",3581,-522,-0.1272,-52,148,305,401,"18.170000000000002",NA,"Central"
"1014","51-9081","Dental Laboratory Technicians","145",155,10,0.069,1,7,12,20,"22.67",NA,"Central"
"1015","51-9111","Packaging and Filling Machine Operators and Tenders","2803",2881,78,0.0278,8,117,189,314,"18.05",NA,"Central"
"1016","51-9124","Coating, Painting, and Spraying Machine Setters, Operators, and Tenders","841",901,60,0.0713,6,24,62,92,"18.899999999999999",NA,"Central"
"1017","51-9161","Computer Numerically Controlled Tool Operators","1139",1117,-22,-0.0193,-2,39,83,120,"18.29",NA,"Central"
"1018","51-9162","Computer Numerically Controlled Tool Programmers","297",386,89,0.2997,9,12,25,46,"23.21",NA,"Central"
"1019","51-9191","Adhesive Bonding Machine Operators and Tenders","111",110,-1,-0.009,0,6,7,13,"18.399999999999999",NA,"Central"
"1020","51-9195","Molders, Shapers, and Casters, Except Metal and Plastic","628",663,35,0.0557,4,23,42,69,"18.05",NA,"Central"
"1021","51-9196","Paper Goods Machine Setters, Operators, and Tenders","843",892,49,0.0581,5,39,58,102,"18.420000000000002",NA,"Central"
"1022","51-9198","Helpers--Production Workers","1505",1394,-111,-0.0738,-11,68,136,193,"17.78",NA,"Central"
"1023","51-9199","Production Workers, All Other","1602",1659,57,0.0356,6,56,120,182,"17.78",NA,"Central"
"1024","53-0000","Transportation and Material Moving Occupations","123830",138990,15160,0.1224,1516,6035,10634,18185,"18.12",NA,"Central"
"1025","53-1047","FirstLine Supervisors of Transportation & Material Moving Workers, Exc Aircraft Cargo Handling Supervisor","6040",6718,678,0.1123,68,233,442,743,"23.88",NA,"Central"
"1026","53-2012","Commercial Pilots","483",474,-9,-0.0186,-1,18,34,51,"129451","**","Central"
"1027","53-3031","Driver/Sales Workers","6283",7096,813,0.1294,81,274,454,809,"13.73",NA,"Central"
"1028","53-3032","Heavy and Tractor-Trailer Truck Drivers","15020",16737,1717,0.1143,172,650,1077,1899,"23.41",NA,"Central"
"1029","53-3033","Light Truck or Delivery Services Drivers","7667",8815,1148,0.1497,115,338,559,1012,"18.57",NA,"Central"
"1030","53-3052","Bus Drivers, Transit and Intercity","808",933,125,0.1547,12,57,43,112,"23.6",NA,"Central"
"1031","53-3058","Passenger Vehicle Drivers, Except Bus Drivers, Transit and Intercity","3644",4743,1099,0.3016,110,276,208,594,"18.05","^^^","Central"
"1032","53-6021","Parking Lot Attendants","1091",1213,122,0.1118,12,56,119,187,"11.62",NA,"Central"
"1033","53-6031","Automotive and Watercraft Service Attendants","991",1060,69,0.0696,7,47,91,145,"13.73",NA,"Central"
"1034","53-7021","Crane and Tower Operators","181",188,7,0.0387,1,5,14,20,"23.84",NA,"Central"
"1035","53-7051","Industrial Truck and Tractor Operators","9902",11575,1673,0.169,167,323,824,1314,"18.93",NA,"Central"
"1036","53-7061","Cleaners of Vehicles and Equipment","1915",2052,137,0.0715,14,97,177,288,"14.23",NA,"Central"
"1037","53-7062","Laborers and Freight, Stock, and Material Movers, Hand","34936",39662,4726,0.1353,473,1632,3245,5350,"17.82",NA,"Central"
"1038","53-7063","Machine Feeders and Offbearers","590",666,76,0.1288,8,36,46,90,"22.24",NA,"Central"
"1039","53-7064","Packers and Packagers, Hand","6346",6789,443,0.0698,44,374,532,950,"14.54",NA,"Central"
"1040","53-7065","Stockers and Order Fillers","24654",26759,2105,0.0854,210,1463,2507,4180,"17.34",NA,"Central"
"1041","53-7081","Refuse and Recyclable Material Collectors","898",1015,117,0.1303,12,40,86,138,"18.89",NA,"Central"
"1042","00-0000","Total, All Occupations","590922",615181,24259,0.0411,2426,25481,39153,67060,"18.78",NA,"West"
"1043","11-0000","Management Occupations","36510",38831,2321,0.0636,232,1321,1832,3385,"47.11",NA,"West"
"1044","11-1011","Chief Executives","467",425,-42,-0.0899,-4,12,18,26,"90.24",NA,"West"
"1045","11-1021","General and Operations Managers","6496",6913,417,0.0642,42,134,416,592,"44.19",NA,"West"
"1046","11-1031","Legislators","143",145,2,0.014,0,3,7,10,"36983","**","West"
"1047","11-2021","Marketing Managers","699",740,41,0.0587,4,14,45,63,"60.82",NA,"West"
"1048","11-2022","Sales Managers","959",995,36,0.0375,4,20,62,86,"59.82",NA,"West"
"1049","11-3010","Administrative Services and Facilities Managers","950",1001,51,0.0537,5,28,49,82,"47.73","^","West"
"1050","11-3021","Computer and Information Systems Managers","1211",1287,76,0.0628,8,20,71,99,"61.52",NA,"West"
"1051","11-3031","Financial Managers","1662",1891,229,0.1378,23,36,89,148,"58.57",NA,"West"
"1052","11-3051","Industrial Production Managers","1351",1430,79,0.0585,8,27,66,101,"47.62",NA,"West"
"1053","11-3061","Purchasing Managers","274",286,12,0.0438,1,6,15,22,"57.39",NA,"West"
"1054","11-3071","Transportation, Storage, and Distribution Managers","528",567,39,0.0739,4,10,30,44,"44.44",NA,"West"
"1055","11-3121","Human Resources Managers","340",355,15,0.0441,2,8,19,29,"49.64",NA,"West"
"1056","11-9013","Farmers, Ranchers, and Other Agricultural Managers","11637",12163,526,0.0452,53,734,414,1201,"35.119999999999997","^","West"
"1057","11-9021","Construction Managers","1036",1134,98,0.0946,10,22,55,87,"46.38",NA,"West"
"1058","11-9031","Education Administrators, Preschool and Childcare Center/Program","214",239,25,0.1168,2,6,10,18,"22.48",NA,"West"
"1059","11-9032","Education Administrators, Elementary and Secondary School","1018",1041,23,0.0226,2,26,48,76,"98078","**","West"
"1060","11-9033","Education Administrators, Postsecondary","380",384,4,0.0105,0,9,18,27,"37.479999999999997",NA,"West"
"1061","11-9039","Education Administrators, All Other","200",204,4,0.02,0,5,9,14,"48.89",NA,"West"
"1062","11-9041","Architectural and Engineering Managers","764",798,34,0.0445,3,14,40,57,"61.52",NA,"West"
"1063","11-9051","Food Service Managers","1143",1279,136,0.119,14,37,97,148,"23.87",NA,"West"
"1064","11-9111","Medical and Health Services Managers","1342",1724,382,0.2846,38,38,78,154,"47.08",NA,"West"
"1065","11-9141","Property, Real Estate, and Community Association Managers","1243",1221,-22,-0.0177,-2,47,46,91,"22.81",NA,"West"
"1066","11-9151","Social and Community Service Managers","519",590,71,0.1368,7,17,30,54,"33.86",NA,"West"
"1067","11-9198","Personal Service Managers; Entertainment & Recreation Managers, Except Gambling; and Managers, All Other","1423",1485,62,0.0436,6,34,71,111,"59.93","^^^","West"
"1068","13-0000","Business and Financial Operations Occupations","34465",36073,1608,0.0467,161,929,2054,3144,"36.29",NA,"West"
"1069","13-1020","Buyers and Purchasing Agents","2979",2758,-221,-0.0742,-22,97,184,259,"37.090000000000003",NA,"West"
"1070","13-1031","Claims Adjusters, Examiners, and Investigators","873",838,-35,-0.0401,-4,20,44,60,"30.03",NA,"West"
"1071","13-1041","Compliance Officers","676",705,29,0.0429,3,17,37,57,"30.17",NA,"West"
"1072","13-1051","Cost Estimators","658",657,-1,-0.0015,0,18,40,58,"30.37",NA,"West"
"1073","13-1071","Human Resources Specialists","2829",3032,203,0.0718,20,79,195,294,"28.9",NA,"West"
"1074","13-1075","Labor Relations Specialists","303",271,-32,-0.1056,-3,8,19,24,"36.57",NA,"West"
"1075","13-1081","Logisticians","1531",1827,296,0.1933,30,35,109,174,"42.12",NA,"West"
"1076","13-1111","Management Analysts","3180",3610,430,0.1352,43,109,195,347,"39.43",NA,"West"
"1077","13-1131","Fundraisers","464",538,74,0.1595,7,16,32,55,"28.52",NA,"West"
"1078","13-1141","Compensation, Benefits, and Job Analysis Specialists","245",260,15,0.0612,2,8,15,25,"29.39",NA,"West"
"1079","13-1151","Training and Development Specialists","1107",1195,88,0.0795,9,35,70,114,"23.16",NA,"West"
"1080","13-1161","Market Research Analysts and Marketing Specialists","2397",2752,355,0.1481,36,61,188,285,"28.9",NA,"West"
"1081","13-1198","Project Management Specialists and Business Operations Specialists, All Other","7602",7737,135,0.0178,14,178,376,568,"35.9","^^^","West"
"1082","13-2011","Accountants and Auditors","4163",4315,152,0.0365,15,118,251,384,"31.19",NA,"West"
"1083","13-2020","Property Appraisers and Assessors","334",336,2,0.006,0,13,12,25,"30.4",NA,"West"
"1084","13-2031","Budget Analysts","181",185,4,0.0221,0,4,10,14,"38.92",NA,"West"
"1085","13-2052","Personal Financial Advisors","771",789,18,0.0233,2,18,38,58,"38.200000000000003",NA,"West"
"1086","13-2072","Loan Officers","989",1000,11,0.0111,1,21,54,76,"30.05",NA,"West"
"1087","13-2098","Financial and Investment Analysts, Financial Risk Specialists, and Financial Specialists, All Other","2029",2079,50,0.0246,5,36,117,158,"35.21","^^^","West"
"1088","15-0000","Computer and Mathematical Occupations","21337",23496,2159,0.1012,216,475,1107,1798,"37.46",NA,"West"
"1089","15-1211","Computer Systems Analysts","2106",2186,80,0.038,8,42,106,156,"45.66",NA,"West"
"1090","15-1212","Information Security Analysts","425",535,110,0.2588,11,7,26,44,"47.61",NA,"West"
"1091","15-1221","Computer and Information Research Scientists","177",207,30,0.1695,3,3,10,16,"55.75",NA,"West"
"1092","15-1231","Computer Network Support Specialists","665",684,19,0.0286,2,13,36,51,"28.32",NA,"West"
"1093","15-1232","Computer User Support Specialists","2775",2928,153,0.0551,15,54,151,220,"22.44",NA,"West"
"1094","15-1241","Computer Network Architects","379",380,1,0.0026,0,5,17,22,"48.26",NA,"West"
"1095","15-1244","Network and Computer Systems Administrators","1224",1230,6,0.0049,1,21,58,80,"37.21",NA,"West"
"1096","15-1245","Database Administrators and Architects","636",676,40,0.0629,4,15,32,51,"47.44","^^^","West"
"1097","15-1251","Computer Programmers","564",484,-80,-0.1418,-8,10,24,26,"30.29",NA,"West"
"1098","15-1256","Software Developers and Software Quality Assurance Analysts and Testers","7789",8997,1208,0.1551,121,195,412,728,"49.49","^^^","West"
"1099","15-1257","Web Developers and Digital Interface Designers","1022",1113,91,0.089,9,25,52,86,"49.49","^^^","West"
"1100","15-1299","Computer Occupations, All Other","2302",2533,231,0.1003,23,56,119,198,"45.95",NA,"West"
"1101","15-2031","Operations Research Analysts","746",881,135,0.181,14,18,35,67,"45.57",NA,"West"
"1102","15-2098","Data Scientists and Mathematical Science Occupations, All Other","393",497,104,0.2646,10,9,22,41,"30.03","^^^","West"
"1103","17-0000","Architecture and Engineering Occupations","14419",15380,961,0.0666,96,344,676,1116,"38.03",NA,"West"
"1104","17-1011","Architects, Except Landscape and Naval","249",243,-6,-0.0241,-1,7,10,16,"38.01",NA,"West"
"1105","17-1022","Surveyors","154",149,-5,-0.0325,0,5,8,13,"29.19",NA,"West"
"1106","17-2011","Aerospace Engineers","1252",1381,129,0.103,13,27,46,86,"54.31",NA,"West"
"1107","17-2051","Civil Engineers","699",731,32,0.0458,3,14,36,53,"38.159999999999997",NA,"West"
"1108","17-2061","Computer Hardware Engineers","246",253,7,0.0285,1,5,12,18,"47.94",NA,"West"
"1109","17-2071","Electrical Engineers","670",708,38,0.0567,4,16,28,48,"45.72",NA,"West"
"1110","17-2072","Electronics Engineers, Except Computer","1558",1604,46,0.0295,5,38,63,106,"54.72",NA,"West"
"1111","17-2081","Environmental Engineers","117",123,6,0.0513,1,3,6,10,"46.02",NA,"West"
"1112","17-2112","Industrial Engineers","1862",2217,355,0.1907,36,44,82,162,"37.6",NA,"West"
"1113","17-2131","Materials Engineers","387",414,27,0.0698,3,8,16,27,"51.86",NA,"West"
"1114","17-2141","Mechanical Engineers","1894",2096,202,0.1067,20,34,82,136,"37.4",NA,"West"
"1115","17-2199","Engineers, All Other","2062",2080,18,0.0087,2,44,85,131,"55.3",NA,"West"
"1116","17-3011","Architectural and Civil Drafters","396",373,-23,-0.0581,-2,12,24,34,"23.21",NA,"West"
"1117","17-3013","Mechanical Drafters","193",190,-3,-0.0155,0,6,12,18,"28.42",NA,"West"
"1118","17-3021","Aerospace Engineering and Operations Technicians","217",248,31,0.1429,3,7,14,24,"29.15",NA,"West"
"1119","17-3022","Civil Engineering Technicians","129",128,-1,-0.0078,0,4,8,12,"28.44",NA,"West"
"1120","17-3023","Electrical and Electronics Engineering Technicians","346",360,14,0.0405,1,11,22,34,"29.06",NA,"West"
"1121","17-3026","Industrial Engineering Technicians","428",460,32,0.0748,3,13,27,43,"28.42",NA,"West"
"1122","17-3027","Mechanical Engineering Technicians","484",513,29,0.0599,3,15,31,49,"28.66",NA,"West"
"1123","17-3031","Surveying and Mapping Technicians","158",154,-4,-0.0253,0,6,14,20,"22.37",NA,"West"
"1124","17-3098","Calibration and Engineering Technologists and Technicians, Except Drafters, All Other","326",350,24,0.0736,2,10,21,33,"29.18","^^^","West"
"1125","19-0000","Life, Physical, and Social Science Occupations","4695",4895,200,0.0426,20,102,314,436,"37.61",NA,"West"
"1126","19-1042","Medical Scientists, Except Epidemiologists","220",259,39,0.1773,4,3,14,21,"38.74",NA,"West"
"1127","19-2012","Physicists","154",167,13,0.0844,1,3,8,12,"57.91",NA,"West"
"1128","19-2031","Chemists","244",256,12,0.0492,1,4,19,24,"36.020000000000003",NA,"West"
"1129","19-2041","Environmental Scientists and Specialists, Including Health","240",244,4,0.0167,0,4,19,23,"32.909999999999997",NA,"West"
"1130","19-2099","Physical Scientists, All Other","141",140,-1,-0.0071,0,2,9,11,"58.69",NA,"West"
"1131","19-3031","Clinical, Counseling, and School Psychologists","288",307,19,0.066,2,8,12,22,"38.96","^^^","West"
"1132","19-3039","Psychologists, All Other","432",431,-1,-0.0023,0,11,17,28,"55.01",NA,"West"
"1133","19-3051","Urban and Regional Planners","125",125,0,0,0,2,9,11,"37.700000000000003",NA,"West"
"1134","19-3099","Social Scientists and Related Workers, All Other","771",775,4,0.0052,0,17,51,68,"47.05",NA,"West"
"1135","19-4021","Biological Technicians","226",244,18,0.0796,2,6,24,32,"23.38",NA,"West"
"1136","19-4031","Chemical Technicians","187",201,14,0.0749,1,3,18,22,"22.74",NA,"West"
"1137","19-4042","Environmental Science and Protection Technicians, Including Health","106",105,-1,-0.0094,0,3,10,13,"18.93",NA,"West"
"1138","19-4061","Social Science Research Assistants","114",126,12,0.1053,1,3,11,15,"22.96",NA,"West"
"1139","19-4099","Life, Physical, and Social Science Technicians, All Other","119",125,6,0.0504,1,3,12,16,"23.64",NA,"West"
"1140","19-5011","Occupational Health and Safety Specialists","427",442,15,0.0351,2,12,19,33,"36.200000000000003",NA,"West"
"1141","21-0000","Community and Social Service Occupations","12340",14018,1678,0.136,168,468,839,1475,"22.89",NA,"West"
"1142","21-1012","Educational, Guidance, School, and Vocational Counselors","1112",1158,46,0.0414,5,37,67,109,"29.46",NA,"West"
"1143","21-1015","Rehabilitation Counselors","522",584,62,0.1188,6,18,33,57,"18.37",NA,"West"
"1144","21-1018","Substance Abuse, Behavioral Disorder, and Mental Health Counselors","924",1146,222,0.2403,22,34,61,117,"23.35",NA,"West"
"1145","21-1021","Child, Family, and School Social Workers","1168",1252,84,0.0719,8,34,76,118,"23.18",NA,"West"
"1146","21-1022","Healthcare Social Workers","831",917,86,0.1035,9,24,55,88,"29.15",NA,"West"
"1147","21-1023","Mental Health and Substance Abuse Social Workers","563",640,77,0.1368,8,17,38,63,"19.010000000000002",NA,"West"
"1148","21-1029","Social Workers, All Other","242",265,23,0.095,2,7,16,25,"25.41",NA,"West"
"1149","21-1091","Health Educators","242",261,19,0.0785,2,8,17,27,"28.85",NA,"West"
"1150","21-1092","Probation Officers and Correctional Treatment Specialists","353",348,-5,-0.0142,0,8,21,29,"23.84",NA,"West"
"1151","21-1093","Social and Human Service Assistants","1817",2016,199,0.1095,20,76,145,241,"17.48",NA,"West"
"1152","21-1094","Community Health Workers","399",471,72,0.1805,7,15,30,52,"22.62",NA,"West"
"1153","21-1099","Community and Social Service Specialists, All Other","430",461,31,0.0721,3,15,31,49,"22.82",NA,"West"
"1154","21-2011","Clergy","2866",3461,595,0.2076,60,130,183,373,"23.35",NA,"West"
"1155","23-0000","Legal Occupations","3159",3255,96,0.0304,10,92,136,238,"30.37",NA,"West"
"1156","23-1011","Lawyers","1340",1388,48,0.0358,5,30,34,69,"45.87",NA,"West"
"1157","23-1023","Judges, Magistrate Judges, and Magistrates","289",279,-10,-0.0346,-1,6,7,12,"39.4",NA,"West"
"1158","23-2011","Paralegals and Legal Assistants","1032",1104,72,0.0698,7,41,72,120,"22.25",NA,"West"
"1159","25-0000","Education, Training, and Library Occupations","32419",33666,1247,0.0385,125,1293,1493,2911,"29.16",NA,"West"
"1160","25-1011","Business Teachers, Postsecondary","285",282,-3,-0.0105,0,13,13,26,"76307","**","West"
"1161","25-1022","Mathematical Science Teachers, Postsecondary","178",178,0,0,0,8,8,16,"77100","**","West"
"1162","25-1042","Biological Science Teachers, Postsecondary","159",169,10,0.0629,1,7,8,16,"77100","**","West"
"1163","25-1066","Psychology Teachers, Postsecondary","209",217,8,0.0383,1,10,10,21,"78050","**","West"
"1164","25-1071","Health Specialties Teachers, Postsecondary","461",524,63,0.1367,6,22,23,51,"96815","**","West"
"1165","25-1072","Nursing Instructors and Teachers, Postsecondary","355",412,57,0.1606,6,17,18,41,"77100","**","West"
"1166","25-1122","Communications Teachers, Postsecondary","103",103,0,0,0,5,5,10,"62494","**","West"
"1167","25-1123","English Language and Literature Teachers, Postsecondary","198",199,1,0.0051,0,9,9,18,"77324","**","West"
"1168","25-1126","Philosophy and Religion Teachers, Postsecondary","146",153,7,0.0479,1,7,7,15,"78366","**","West"
"1169","25-1194","Vocational Education Teachers, Postsecondary","211",209,-2,-0.0095,0,9,10,19,"28.55",NA,"West"
"1170","25-1199","Postsecondary Teachers, All Other","655",645,-10,-0.0153,-1,29,30,58,"49863","**","West"
"1171","25-2011","Preschool Teachers, Except Special Education","1516",1818,302,0.1992,30,68,97,195,"13.86",NA,"West"
"1172","25-2021","Elementary School Teachers, Except Special Education","3646",3699,53,0.0145,5,113,147,265,"74068","**","West"
"1173","25-2022","Middle School Teachers, Except Special and Career/Technical Education","2527",2569,42,0.0166,4,78,102,184,"61634","**","West"
"1174","25-2031","Secondary School Teachers, Except Special and Career/Technical Education","6425",6562,137,0.0213,14,172,263,449,"76006","**","West"
"1175","25-2052","Special Education Teachers, Kindergarten and Elementary School","560",569,9,0.0161,1,18,22,41,"73089","**","West"
"1176","25-2057","Special Education Teachers, Middle School","398",404,6,0.0151,1,13,16,30,"60041","**","West"
"1177","25-2058","Special Education Teachers, Secondary School","1022",1047,25,0.0245,2,34,41,77,"73877","**","West"
"1178","25-3011","Adult Basic and Secondary Education and Literacy Teachers and Instructors","121",106,-15,-0.124,-2,7,6,11,"29.14",NA,"West"
"1179","25-3021","Self-Enrichment Education Teachers","808",949,141,0.1745,14,52,47,113,"14.25",NA,"West"
"1180","25-3031","Substitute Teachers, Short-Term","1037",1109,72,0.0694,7,64,58,129,"14.16",NA,"West"
"1181","25-3097","Teachers and Instructors, All Other, Except Substitute Teachers","856",915,59,0.0689,6,53,48,107,"17.940000000000001","^^^","West"
"1182","25-4022","Librarians and Media Collections Specialists","696",701,5,0.0072,0,34,30,64,"22.76",NA,"West"
"1183","25-4031","Library Technicians","630",574,-56,-0.0889,-6,50,37,81,"14.5",NA,"West"
"1184","25-9031","Instructional Coordinators","550",571,21,0.0382,2,28,24,54,"29.29",NA,"West"
"1185","25-9045","Teaching Assistants, Except Postsecondary","4886",5123,237,0.0485,24,224,234,482,"28669","**","West"
"1186","27-0000","Arts, Design, Entertainment, Sports, and Media Occupations","9114",9858,744,0.0816,74,392,596,1062,"22.45",NA,"West"
"1187","27-1011","Art Directors","104",102,-2,-0.0192,0,5,5,10,"38.72",NA,"West"
"1188","27-1023","Floral Designers","180",161,-19,-0.1056,-2,5,10,13,"12.03",NA,"West"
"1189","27-1024","Graphic Designers","1036",996,-40,-0.0386,-4,31,60,87,"23.5",NA,"West"
"1190","27-1025","Interior Designers","123",130,7,0.0569,1,4,8,13,"23.6",NA,"West"
"1191","27-1026","Merchandise Displayers and Window Trimmers","363",364,1,0.0028,0,11,22,33,"14.17",NA,"West"
"1192","27-2022","Coaches and Scouts","1539",1652,113,0.0734,11,91,128,230,"30124","**","West"
"1193","27-2042","Musicians and Singers","857",1031,174,0.203,17,56,53,126,"47.38",NA,"West"
"1194","27-2090","Miscellaneous Entertainers and Performers, Sports and Related Workers","102",116,14,0.1373,1,4,6,11,"17.59","^","West"
"1195","27-3011","Radio and Television Announcers","106",109,3,0.0283,0,4,6,10,"14.35",NA,"West"
"1196","27-3031","Public Relations Specialists","736",792,56,0.0761,6,19,50,75,"29.17",NA,"West"
"1197","27-3041","Editors","216",207,-9,-0.0417,-1,7,13,19,"29.63",NA,"West"
"1198","27-3042","Technical Writers","212",225,13,0.0613,1,6,14,21,"30.35",NA,"West"
"1199","27-3043","Writers and Authors","323",316,-7,-0.0217,-1,13,18,30,"29.37",NA,"West"
"1200","27-3099","Media and Communication Workers, All Other","101",107,6,0.0594,1,4,6,11,"17.8","†","West"
"1201","27-4011","Audio and Video Equipment Technicians","104",126,22,0.2115,2,3,8,13,"18.48",NA,"West"
"1202","27-4021","Photographers","493",536,43,0.0872,4,17,29,50,"17.2",NA,"West"
"1203","29-0000","Healthcare Practitioners and Technical Occupations","40216",42915,2699,0.0671,270,1060,1253,2583,"29.67",NA,"West"
"1204","29-1011","Chiropractors","181",189,8,0.0442,1,3,2,6,"29.26",NA,"West"
"1205","29-1021","Dentists, General","332",333,1,0.003,0,6,3,9,"80.3",NA,"West"
"1206","29-1031","Dietitians and Nutritionists","221",228,7,0.0317,1,7,8,16,"29.16",NA,"West"
"1207","29-1041","Optometrists","114",118,4,0.0351,0,2,1,3,"61.83",NA,"West"
"1208","29-1051","Pharmacists","1318",1259,-59,-0.0448,-6,24,25,43,"61.38",NA,"West"
"1209","29-1071","Physician Assistants","441",570,129,0.2925,13,8,20,41,"48.19",NA,"West"
"1210","29-1122","Occupational Therapists","608",692,84,0.1382,8,14,21,43,"38.07",NA,"West"
"1211","29-1123","Physical Therapists","945",1074,129,0.1365,13,20,21,54,"46.01",NA,"West"
"1212","29-1126","Respiratory Therapists","716",849,133,0.1858,13,17,20,50,"29.12",NA,"West"
"1213","29-1127","Speech-Language Pathologists","849",1025,176,0.2073,18,22,34,74,"37.28",NA,"West"
"1214","29-1129","Therapists, All Other","109",118,9,0.0826,1,4,4,9,"18.600000000000001",NA,"West"
"1215","29-1131","Veterinarians","401",455,54,0.1347,5,7,7,19,"47.18",NA,"West"
"1216","29-1141","Registered Nurses","14254",15029,775,0.0544,78,391,368,837,"36.06",NA,"West"
"1217","29-1171","Nurse Practitioners","891",1358,467,0.5241,47,24,35,106,"48.82",NA,"West"
"1218","29-1215","Family Medicine Physicians","250",253,3,0.012,0,4,3,7,"94.24",NA,"West"
"1219","29-1216","General Internal Medicine Physicians","206",198,-8,-0.0388,-1,3,2,4,"79.760000000000005",NA,"West"
"1220","29-1221","Pediatricians, General","103",98,-5,-0.0485,0,2,1,3,"94.01",NA,"West"
"1221","29-1228","Physicians, All Other; and Ophthalmologists, Except Pediatric","2223",2279,56,0.0252,6,36,25,67,"37.450000000000003","^^^","West"
"1222","29-1248","Surgeons, Except Ophthalmologists","134",122,-12,-0.0896,-1,2,1,2,"# ^^^",NA,"West"
"1223","29-1292","Dental Hygienists","906",933,27,0.0298,3,33,23,59,"36.97",NA,"West"
"1224","29-2010","Clinical Laboratory Technologists and Technicians","1404",1466,62,0.0442,6,37,53,96,"23.29",NA,"West"
"1225","29-2031","Cardiovascular Technologists and Technicians","159",165,6,0.0377,1,4,7,12,"29.14",NA,"West"
"1226","29-2032","Diagnostic Medical Sonographers","314",353,39,0.1242,4,9,14,27,"37.56",NA,"West"
"1227","29-2034","Radiologic Technologists","1040",1074,34,0.0327,3,29,45,77,"29.12",NA,"West"
"1228","29-2035","Magnetic Resonance Imaging Technologists","187",192,5,0.0267,0,5,8,13,"36.04",NA,"West"
"1229","29-2040","Emergency Medical Technicians and Paramedics","1346",1405,59,0.0438,6,26,64,96,"17.760000000000002","^","West"
"1230","29-2051","Dietetic Technicians","141",142,1,0.0071,0,4,6,10,"16.809999999999999",NA,"West"
"1231","29-2052","Pharmacy Technicians","1524",1563,39,0.0256,4,42,66,112,"17.48",NA,"West"
"1232","29-2053","Psychiatric Technicians","155",182,27,0.1742,3,5,7,15,"16.739999999999998",NA,"West"
"1233","29-2055","Surgical Technologists","370",384,14,0.0378,1,10,16,27,"22.92",NA,"West"
"1234","29-2061","Licensed Practical and Licensed Vocational Nurses","4324",4500,176,0.0407,18,149,184,351,"22.63",NA,"West"
"1235","29-2081","Opticians, Dispensing","303",307,4,0.0132,0,13,10,23,"22.04",NA,"West"
"1236","29-2098","Medical Dosimetrists, Medical Records Specialists, and Health Technologists and Technicians, All Other","1478",1550,72,0.0487,7,41,65,113,"22.55","^^^","West"
"1237","29-9098","Health Information Technologists, Medical Registrars, Surgical Assistants, & Healthcare Practitioners, AO","222",255,33,0.1486,3,6,10,19,"26.19","^^^","West"
"1238","31-0000","Healthcare Support Occupations","21708",24950,3242,0.1493,324,1346,1460,3130,"14.11",NA,"West"
"1239","31-1120","Home Health and Personal Care Aides","8096",10320,2224,0.2747,222,590,521,1333,"11.65",NA,"West"
"1240","31-1131","Nursing Assistants","6183",6148,-35,-0.0057,-4,395,349,740,"14.26",NA,"West"
"1241","31-2011","Occupational Therapy Assistants","504",654,150,0.2976,15,29,42,86,"29.36",NA,"West"
"1242","31-2021","Physical Therapist Assistants","817",1062,245,0.2999,24,40,71,135,"29.46",NA,"West"
"1243","31-9011","Massage Therapists","174",203,29,0.1667,3,11,10,24,"18.829999999999998",NA,"West"
"1244","31-9091","Dental Assistants","888",916,28,0.0315,3,41,63,107,"21.99",NA,"West"
"1245","31-9092","Medical Assistants","2990",3438,448,0.1498,45,132,240,417,"17.63",NA,"West"
"1246","31-9093","Medical Equipment Preparers","248",255,7,0.0282,1,14,17,32,"17.55",NA,"West"
"1247","31-9097","Phlebotomists","661",745,84,0.1271,8,30,51,89,"17.489999999999998",NA,"West"
"1248","31-9099","Healthcare Support Workers, All Other","181",189,8,0.0442,1,10,12,23,"23.15",NA,"West"
"1249","33-0000","Protective Service Occupations","9364",9344,-20,-0.0021,-2,426,593,1017,"22.95",NA,"West"
"1250","33-1012","First-Line Supervisors of Police and Detectives","267",268,1,0.0037,0,6,11,17,"40.630000000000003",NA,"West"
"1251","33-1021","First-Line Supervisors of Fire Fighting and Prevention Workers","164",166,2,0.0122,0,4,7,11,"36.89",NA,"West"
"1252","33-1090","Miscellaneous First-Line Supervisors, Protective Service Workers","167",165,-2,-0.012,0,6,10,16,"25.23","^","West"
"1253","33-2011","Firefighters","1824",1857,33,0.0181,3,41,95,139,"23.08",NA,"West"
"1254","33-3011","Bailiffs","130",125,-5,-0.0385,0,5,7,12,"22.43",NA,"West"
"1255","33-3012","Correctional Officers and Jailers","902",798,-104,-0.1153,-10,32,46,68,"22.84",NA,"West"
"1256","33-3021","Detectives and Criminal Investigators","152",153,1,0.0066,0,4,7,11,"37.39",NA,"West"
"1257","33-3051","Police and Sheriff's Patrol Officers","2335",2332,-3,-0.0013,0,58,118,176,"31.74",NA,"West"
"1258","33-9032","Security Guards","2121",2101,-20,-0.0094,-2,112,164,274,"13.86",NA,"West"
"1259","33-9098","School Bus Monitors and Protective Service Workers, All Other","341",351,10,0.0293,1,48,38,87,"15.11","^^^","West"
"1260","35-0000","Food Preparation and Serving Related Occupations","43365",49019,5654,0.1304,565,3530,4688,8783,"10.82",NA,"West"
"1261","35-1011","Chefs and Head Cooks","137",163,26,0.1898,3,4,15,22,"21.4",NA,"West"
"1262","35-1012","First-Line Supervisors of Food Preparation and Serving Workers","4718",5531,813,0.1723,81,229,522,832,"16.940000000000001",NA,"West"
"1263","35-2011","Cooks, Fast Food","2485",2345,-140,-0.0563,-14,142,207,335,"10.43",NA,"West"
"1264","35-2012","Cooks, Institution and Cafeteria","2050",2038,-12,-0.0059,-1,120,175,294,"14.16",NA,"West"
"1265","35-2014","Cooks, Restaurant","3440",4901,1461,0.4247,146,245,357,748,"13.79",NA,"West"
"1266","35-2021","Food Preparation Workers","2906",3092,186,0.064,19,236,276,531,"11.77",NA,"West"
"1267","35-3011","Bartenders","1805",2171,366,0.2028,37,90,241,368,"10.039999999999999",NA,"West"
"1268","35-3023","Fast Food and Counter Workers","15435",16996,1561,0.1011,156,1572,1714,3442,"10.69",NA,"West"
"1269","35-3031","Waiters and Waitresses","5682",6465,783,0.1378,78,446,725,1249,"9.7799999999999994",NA,"West"
"1270","35-3041","Food Servers, Nonrestaurant","1175",1193,18,0.0153,2,94,92,188,"11.89",NA,"West"
"1271","35-9021","Dishwashers","1018",1155,137,0.1346,14,82,91,187,"10.71",NA,"West"
"1272","35-9031","Hosts and Hostesses, Restaurant, Lounge, and Coffee Shop","1251",1500,249,0.199,25,163,155,343,"10.34",NA,"West"
"1273","37-0000","Building and Grounds Cleaning and Maintenance Occupations","18837",19197,360,0.0191,36,1057,1403,2496,"14.23",NA,"West"
"1274","37-1011","First-Line Supervisors of Housekeeping and Janitorial Workers","700",698,-2,-0.0029,0,30,48,78,"21.93",NA,"West"
"1275","37-1012","First-Line Supervisors of Landscaping, Lawn Service, and Groundskeeping Workers","857",853,-4,-0.0047,0,26,61,87,"22.91",NA,"West"
"1276","37-2011","Janitors and Cleaners, Except Maids and Housekeeping Cleaners","9395",9614,219,0.0233,22,593,666,1281,"14.18",NA,"West"
"1277","37-2012","Maids and Housekeeping Cleaners","2687",2705,18,0.0067,2,183,174,359,"11.36",NA,"West"
"1278","37-3011","Landscaping and Groundskeeping Workers","4859",4977,118,0.0243,12,212,422,646,"14.49",NA,"West"
"1279","39-0000","Personal Care and Service Occupations","10464",11338,874,0.0835,87,668,824,1579,"11.97",NA,"West"
"1280","39-2021","Nonfarm Animal Caretakers","567",701,134,0.2363,13,41,53,107,"10.91",NA,"West"
"1281","39-3091","Amusement and Recreation Attendants","450",550,100,0.2222,10,49,56,115,"10.46",NA,"West"
"1282","39-5012","Hairdressers, Hairstylists, and Cosmetologists","2200",2174,-26,-0.0118,-3,116,122,235,"13.63",NA,"West"
"1283","39-9011","Childcare Workers","2390",2492,102,0.0427,10,164,171,345,"10.96",NA,"West"
"1284","39-9031","Fitness Trainers and Aerobics Instructors","944",1102,158,0.1674,16,60,97,173,"14.16",NA,"West"
"1285","39-9032","Recreation Workers","1192",1261,69,0.0579,7,72,116,195,"13.88",NA,"West"
"1286","39-9041","Residential Advisors","248",276,28,0.1129,3,13,24,40,"14.62",NA,"West"
"1287","41-0000","Sales and Related Occupations","49738",47327,-2411,-0.0485,-241,2540,3863,6162,"13.99",NA,"West"
"1288","41-1011","First-Line Supervisors of Retail Sales Workers","5086",4557,-529,-0.104,-53,170,334,451,"18.23",NA,"West"
"1289","41-1012","First-Line Supervisors of Non-Retail Sales Workers","1013",936,-77,-0.076,-8,28,58,78,"37.82",NA,"West"
"1290","41-2011","Cashiers","11782",10556,-1226,-0.1041,-123,950,1069,1896,"10.84",NA,"West"
"1291","41-2021","Counter and Rental Clerks","1060",1065,5,0.0047,0,48,73,121,"14.04",NA,"West"
"1292","41-2031","Retail Salespersons","14568",13991,-577,-0.0396,-58,798,1180,1920,"13.16",NA,"West"
"1293","41-3011","Advertising Sales Agents","237",205,-32,-0.135,-3,7,20,24,"21.75",NA,"West"
"1294","41-3021","Insurance Sales Agents","2023",2115,92,0.0455,9,69,116,194,"23.29",NA,"West"
"1295","41-3031","Securities, Commodities, and Financial Services Sales Agents","738",762,24,0.0325,2,17,47,66,"23.53",NA,"West"
"1296","41-3041","Travel Agents","108",112,4,0.037,0,5,7,12,"18.27",NA,"West"
"1297","41-3091","Sales Representatives of Services, Except Advertising, Insurance, Financial Services, and Travel","2783",2863,80,0.0287,8,71,248,327,"27.87",NA,"West"
"1298","41-4011","Sales Representatives, Wholesale and Manufacturing, Technical and Scientific Products","794",826,32,0.0403,3,24,55,82,"37.86",NA,"West"
"1299","41-4012","Sales Representatives, Wholesale and Manufacturing, Except Technical and Scientific Products","4993",5150,157,0.0314,16,150,343,509,"29.61",NA,"West"
"1300","41-9022","Real Estate Sales Agents","1237",1243,6,0.0049,1,52,54,107,"17.39",NA,"West"
"1301","41-9031","Sales Engineers","168",175,7,0.0417,1,3,14,18,"47.62",NA,"West"
"1302","41-9099","Sales and Related Workers, All Other","462",422,-40,-0.0866,-4,20,36,52,"13.63",NA,"West"
"1303","43-0000","Office and Administrative Support Occupations","67591",64925,-2666,-0.0394,-267,3147,4064,6944,"17.91",NA,"West"
"1304","43-1011","First-Line Supervisors of Office and Administrative Support Workers","4511",4372,-139,-0.0308,-14,165,271,422,"27.82",NA,"West"
"1305","43-2011","Switchboard Operators, Including Answering Service","132",98,-34,-0.2576,-3,6,7,10,"17.420000000000002",NA,"West"
"1306","43-3011","Bill and Account Collectors","364",340,-24,-0.0659,-2,13,25,36,"18.23",NA,"West"
"1307","43-3021","Billing and Posting Clerks","1468",1459,-9,-0.0061,-1,60,90,149,"17.87",NA,"West"
"1308","43-3031","Bookkeeping, Accounting, and Auditing Clerks","5224",5020,-204,-0.0391,-20,300,262,542,"18.45",NA,"West"
"1309","43-3051","Payroll and Timekeeping Clerks","455",379,-76,-0.167,-8,20,23,35,"22.57",NA,"West"
"1310","43-3061","Procurement Clerks","294",283,-11,-0.0374,-1,8,18,25,"18.350000000000001",NA,"West"
"1311","43-3071","Tellers","1942",1620,-322,-0.1658,-32,72,112,152,"14.38",NA,"West"
"1312","43-4031","Court, Municipal, and License Clerks","1136",1159,23,0.0202,2,56,58,116,"17.87",NA,"West"
"1313","43-4051","Customer Service Representatives","8650",8524,-126,-0.0146,-13,404,675,1066,"17.739999999999998",NA,"West"
"1314","43-4061","Eligibility Interviewers, Government Programs","334",332,-2,-0.006,0,12,17,29,"18.420000000000002",NA,"West"
"1315","43-4071","File Clerks","288",245,-43,-0.1493,-4,14,16,26,"17.739999999999998",NA,"West"
"1316","43-4081","Hotel, Motel, and Resort Desk Clerks","380",431,51,0.1342,5,24,43,72,"11.2",NA,"West"
"1317","43-4111","Interviewers, Except Eligibility and Loan","361",341,-20,-0.0554,-2,20,23,41,"17.739999999999998",NA,"West"
"1318","43-4121","Library Assistants, Clerical","637",583,-54,-0.0848,-5,54,39,88,"11.1",NA,"West"
"1319","43-4131","Loan Interviewers and Clerks","722",709,-13,-0.018,-1,21,42,62,"21.47",NA,"West"
"1320","43-4151","Order Clerks","412",332,-80,-0.1942,-8,16,23,31,"18.13",NA,"West"
"1321","43-4161","Human Resources Assistants, Except Payroll and Timekeeping","563",519,-44,-0.0782,-4,21,33,50,"19.420000000000002",NA,"West"
"1322","43-4171","Receptionists and Information Clerks","3934",3961,27,0.0069,3,220,273,496,"13.82",NA,"West"
"1323","43-4199","Information and Record Clerks, All Other","402",411,9,0.0224,1,17,27,45,"22.3",NA,"West"
"1324","43-5011","Cargo and Freight Agents","266",294,28,0.1053,3,11,17,31,"21.54",NA,"West"
"1325","43-5021","Couriers and Messengers","295",273,-22,-0.0746,-2,12,16,26,"14.28",NA,"West"
"1326","43-5031","Police, Fire, and Ambulance Dispatchers","412",413,1,0.0024,0,14,23,37,"22.92",NA,"West"
"1327","43-5032","Dispatchers, Except Police, Fire, and Ambulance","725",744,19,0.0262,2,26,41,69,"21.04",NA,"West"
"1328","43-5041","Meter Readers, Utilities","100",83,-17,-0.17,-2,3,4,5,"22.68",NA,"West"
"1329","43-5051","Postal Service Clerks","350",318,-32,-0.0914,-3,15,12,24,"24.64",NA,"West"
"1330","43-5052","Postal Service Mail Carriers","1400",1271,-129,-0.0921,-13,46,48,81,"25.21",NA,"West"
"1331","43-5053","Postal Service Mail Sorters, Processors, and Processing Machine Operators","176",152,-24,-0.1364,-2,9,5,12,"23.69",NA,"West"
"1332","43-5061","Production, Planning, and Expediting Clerks","2141",2287,146,0.0682,15,79,144,238,"22.82",NA,"West"
"1333","43-5071","Shipping, Receiving, and Traffic Clerks","4450",4248,-202,-0.0454,-20,159,256,395,"17.600000000000001",NA,"West"
"1334","43-5111","Weighers, Measurers, Checkers, and Samplers, Recordkeeping","207",221,14,0.0676,1,8,12,21,"18.29",NA,"West"
"1335","43-6011","Executive Secretaries and Executive Administrative Assistants","1123",887,-236,-0.2102,-24,51,56,83,"28.37",NA,"West"
"1336","43-6012","Legal Secretaries","405",309,-96,-0.237,-10,18,20,28,"22.4",NA,"West"
"1337","43-6013","Medical Secretaries","2847",3012,165,0.058,16,149,164,329,"17.61",NA,"West"
"1338","43-6014","Secretaries and Administrative Assistants, Except Legal, Medical, and Executive","6477",5875,-602,-0.0929,-60,314,345,599,"17.87",NA,"West"
"1339","43-9021","Data Entry Keyers","407",314,-93,-0.2285,-9,16,23,30,"17.420000000000002",NA,"West"
"1340","43-9022","Word Processors and Typists","132",84,-48,-0.3636,-5,6,6,7,"22.92",NA,"West"
"1341","43-9041","Insurance Claims and Policy Processing Clerks","828",813,-15,-0.0181,-2,29,48,75,"18.059999999999999",NA,"West"
"1342","43-9051","Mail Clerks and Mail Machine Operators, Except Postal Service","283",249,-34,-0.1201,-3,14,17,28,"14.26",NA,"West"
"1343","43-9061","Office Clerks, General","11192",10684,-508,-0.0454,-51,597,649,1195,"17.739999999999998",NA,"West"
"1344","43-9199","Office and Administrative Support Workers, All Other","425",429,4,0.0094,0,18,30,48,"17.420000000000002",NA,"West"
"1345","45-0000","Farming, Fishing, and Forestry Occupations","2549",2650,101,0.0396,10,109,295,414,"14.76",NA,"West"
"1346","45-1011","First-Line Supervisors of Farming, Fishing, and Forestry Workers","162",168,6,0.037,1,6,17,24,"27.78",NA,"West"
"1347","45-2092","Farmworkers and Laborers, Crop, Nursery, and Greenhouse","1680",1748,68,0.0405,7,73,196,276,"14.29",NA,"West"
"1348","45-2093","Farmworkers, Farm, Ranch, and Aquacultural Animals","289",296,7,0.0242,1,12,33,46,"13.97",NA,"West"
"1349","47-0000","Construction and Extraction Occupations","18334",19160,826,0.0451,83,558,1284,1925,"23.09",NA,"West"
"1350","47-1011","First-Line Supervisors of Construction Trades and Extraction Workers","1592",1659,67,0.0421,7,46,105,158,"30.17",NA,"West"
"1351","47-2021","Brickmasons and Blockmasons","177",179,2,0.0113,0,6,11,17,"28.9",NA,"West"
"1352","47-2031","Carpenters","2171",2190,19,0.0088,2,64,136,202,"23.19",NA,"West"
"1353","47-2051","Cement Masons and Concrete Finishers","549",543,-6,-0.0109,-1,13,36,48,"23.09",NA,"West"
"1354","47-2061","Construction Laborers","3774",4075,301,0.0798,30,116,265,411,"18.63",NA,"West"
"1355","47-2073","Operating Engineers and Other Construction Equipment Operators","1655",1687,32,0.0193,3,55,120,178,"23.63",NA,"West"
"1356","47-2111","Electricians","2482",2706,224,0.0902,22,75,190,287,"24.58",NA,"West"
"1357","47-2121","Glaziers","218",231,13,0.0596,1,6,17,24,"22.89",NA,"West"
"1358","47-2141","Painters, Construction and Maintenance","725",755,30,0.0414,3,22,41,66,"22.19",NA,"West"
"1359","47-2152","Plumbers, Pipefitters, and Steamfitters","1038",1087,49,0.0472,5,31,76,112,"28.9",NA,"West"
"1360","47-2181","Roofers","491",512,21,0.0428,2,12,35,49,"22.42",NA,"West"
"1361","47-2221","Structural Iron and Steel Workers","171",182,11,0.0643,1,4,14,19,"28.9",NA,"West"
"1362","47-3013","Helpers--Electricians","237",237,0,0,0,7,21,28,"16.82",NA,"West"
"1363","47-3019","Helpers, Construction Trades, All Other","113",118,5,0.0442,0,3,10,13,"12.28",NA,"West"
"1364","47-4011","Construction and Building Inspectors","234",209,-25,-0.1068,-2,12,13,23,"30.08",NA,"West"
"1365","47-4041","Hazardous Materials Removal Workers","144",160,16,0.1111,2,6,12,20,"22.44",NA,"West"
"1366","47-4051","Highway Maintenance Workers","683",674,-9,-0.0132,-1,27,43,69,"22.66",NA,"West"
"1367","47-4071","Septic Tank Servicers and Sewer Pipe Cleaners","206",212,6,0.0291,1,7,17,25,"23.09",NA,"West"
"1368","49-0000","Installation, Maintenance, and Repair Occupations","21843",23080,1237,0.0566,124,705,1410,2239,"22.83",NA,"West"
"1369","49-1011","First-Line Supervisors of Mechanics, Installers, and Repairers","1653",1733,80,0.0484,8,49,101,158,"30.87",NA,"West"
"1370","49-2011","Computer, Automated Teller, and Office Machine Repairers","244",238,-6,-0.0246,-1,7,18,24,"18.05",NA,"West"
"1371","49-2022","Telecommunications Equipment Installers and Repairers, Except Line Installers","697",601,-96,-0.1377,-10,23,50,63,"29.06",NA,"West"
"1372","49-2094","Electrical and Electronics Repairers, Commercial and Industrial Equipment","115",121,6,0.0522,1,3,6,10,"29.07",NA,"West"
"1373","49-2098","Security and Fire Alarm Systems Installers","109",114,5,0.0459,0,3,9,12,"22.65",NA,"West"
"1374","49-3011","Aircraft Mechanics and Service Technicians","326",379,53,0.1626,5,10,18,33,"27.81",NA,"West"
"1375","49-3021","Automotive Body and Related Repairers","522",519,-3,-0.0057,0,16,31,47,"22.42",NA,"West"
"1376","49-3023","Automotive Service Technicians and Mechanics","2882",2810,-72,-0.025,-7,85,193,271,"18.57",NA,"West"
"1377","49-3031","Bus and Truck Mechanics and Diesel Engine Specialists","1226",1307,81,0.0661,8,36,79,123,"22.71",NA,"West"
"1378","49-3042","Mobile Heavy Equipment Mechanics, Except Engines","407",480,73,0.1794,7,13,30,50,"24.18",NA,"West"
"1379","49-9012","Control and Valve Installers and Repairers, Except Mechanical Door","121",123,2,0.0165,0,3,7,10,"37.42",NA,"West"
"1380","49-9021","Heating, Air Conditioning, and Refrigeration Mechanics and Installers","1748",1836,88,0.0503,9,46,122,177,"23.17",NA,"West"
"1381","49-9041","Industrial Machinery Mechanics","1859",2359,500,0.269,50,65,114,229,"24.23",NA,"West"
"1382","49-9043","Maintenance Workers, Machinery","339",393,54,0.1593,5,12,20,37,"23.38",NA,"West"
"1383","49-9044","Millwrights","182",197,15,0.0824,2,6,11,19,"29.07",NA,"West"
"1384","49-9051","Electrical Power-Line Installers and Repairers","406",402,-4,-0.0099,0,8,27,35,"36.47",NA,"West"
"1385","49-9062","Medical Equipment Repairers","141",159,18,0.1277,2,7,9,18,"28.9",NA,"West"
"1386","49-9071","Maintenance and Repair Workers, General","5845",6199,354,0.0606,35,212,351,598,"22.4",NA,"West"
"1387","49-9098","Helpers--Installation, Maintenance, and Repair Workers","276",299,23,0.0833,2,12,24,38,"14.07",NA,"West"
"1388","49-9099","Installation, Maintenance, and Repair Workers, All Other","459",481,22,0.0479,2,17,31,50,"18.239999999999998",NA,"West"
"1389","51-0000","Production Occupations","63155",62810,-345,-0.0055,-34,2315,4458,6739,"18.09",NA,"West"
"1390","51-1011","First-Line Supervisors of Production and Operating Workers","3935",4138,203,0.0516,20,121,272,413,"29.28",NA,"West"
"1391","51-2028","Electrical, Electronic, and Electromechanical Assemblers, Except Coil Winders, Tapers, and Finishers","2992",3275,283,0.0946,28,126,201,355,"17.510000000000002",NA,"West"
"1392","51-2090","Miscellaneous Assemblers and Fabricators","11027",10279,-748,-0.0678,-75,406,760,1091,"17.63",NA,"West"
"1393","51-3011","Bakers","597",651,54,0.0905,5,35,47,87,"13.91",NA,"West"
"1394","51-3021","Butchers and Meat Cutters","523",518,-5,-0.0096,0,21,39,60,"14.43",NA,"West"
"1395","51-3022","Meat, Poultry, and Fish Cutters and Trimmers","440",456,16,0.0364,2,18,33,53,"14.14",NA,"West"
"1396","51-3092","Food Batchmakers","780",814,34,0.0436,3,37,59,99,"14.38",NA,"West"
"1397","51-3099","Food Processing Workers, All Other","221",224,3,0.0136,0,8,14,22,"13.85",NA,"West"
"1398","51-4021","Extruding and Drawing Machine Setters, Operators, and Tenders, Metal and Plastic","457",415,-42,-0.0919,-4,15,27,38,"17.920000000000002",NA,"West"
"1399","51-4031","Cutting, Punching, and Press Machine Setters, Operators, and Tenders, Metal and Plastic","2410",2331,-79,-0.0328,-8,75,163,230,"18.09",NA,"West"
"1400","51-4033","Grinding, Lapping, Polishing, and Buffing Machine Tool Setters, Operators, and Tenders, Metal and Plastic","1008",1013,5,0.005,0,46,70,116,"18.09",NA,"West"
"1401","51-4034","Lathe and Turning Machine Tool Setters, Operators, and Tenders, Metal and Plastic","146",142,-4,-0.0274,0,5,10,15,"23.05",NA,"West"
"1402","51-4041","Machinists","4057",4419,362,0.0892,36,142,288,466,"22.29",NA,"West"
"1403","51-4052","Pourers and Casters, Metal","110",103,-7,-0.0636,-1,2,7,8,"22.67",NA,"West"
"1404","51-4072","Molding, Coremaking, and Casting Machine Setters, Operators, and Tenders, Metal and Plastic","1949",1773,-176,-0.0903,-18,60,126,168,"17.649999999999999",NA,"West"
"1405","51-4081","Multiple Machine Tool Setters, Operators, and Tenders, Metal and Plastic","1793",1928,135,0.0753,14,60,126,200,"18.05",NA,"West"
"1406","51-4111","Tool and Die Makers","894",881,-13,-0.0145,-1,33,56,88,"23.65",NA,"West"
"1407","51-4121","Welders, Cutters, Solderers, and Brazers","2389",2659,270,0.113,27,66,199,292,"22.47",NA,"West"
"1408","51-4122","Welding, Soldering, and Brazing Machine Setters, Operators, and Tenders","255",253,-2,-0.0078,0,7,20,27,"18.05",NA,"West"
"1409","51-4191","Heat Treating Equipment Setters, Operators, and Tenders, Metal and Plastic","124",123,-1,-0.0081,0,4,8,12,"17.97",NA,"West"
"1410","51-4193","Plating and Coating Machine Setters, Operators, and Tenders, Metal and Plastic","731",730,-1,-0.0014,0,24,49,73,"17.48",NA,"West"
"1411","51-5111","Prepress Technicians and Workers","207",184,-23,-0.1111,-2,7,19,24,"18.670000000000002",NA,"West"
"1412","51-5112","Printing Press Operators","1119",962,-157,-0.1403,-16,38,73,95,"18.09",NA,"West"
"1413","51-5113","Print Binding and Finishing Workers","236",185,-51,-0.2161,-5,10,13,18,"14.45",NA,"West"
"1414","51-6011","Laundry and Dry-Cleaning Workers","699",757,58,0.083,6,47,49,102,"11.29",NA,"West"
"1415","51-6031","Sewing Machine Operators","1018",959,-59,-0.058,-6,60,52,106,"14.62",NA,"West"
"1416","51-7011","Cabinetmakers and Bench Carpenters","471",518,47,0.0998,5,19,27,51,"17.91",NA,"West"
"1417","51-7041","Sawing Machine Setters, Operators, and Tenders, Wood","127",131,4,0.0315,0,5,10,15,"14.8",NA,"West"
"1418","51-7042","Woodworking Machine Setters, Operators, and Tenders, Except Sawing","292",312,20,0.0685,2,9,22,33,"17.41",NA,"West"
"1419","51-8031","Water and Wastewater Treatment Plant and System Operators","604",555,-49,-0.0811,-5,16,36,47,"23.16",NA,"West"
"1420","51-9011","Chemical Equipment Operators and Tenders","697",703,6,0.0086,1,15,54,70,"22.03",NA,"West"
"1421","51-9012","Separating, Filtering, Clarifying, Precipitating, and Still Machine Setters, Operators, and Tenders","154",159,5,0.0325,0,3,12,15,"18.23",NA,"West"
"1422","51-9021","Crushing, Grinding, and Polishing Machine Setters, Operators, and Tenders","127",124,-3,-0.0236,0,4,9,13,"18.34",NA,"West"
"1423","51-9023","Mixing and Blending Machine Setters, Operators, and Tenders","520",518,-2,-0.0038,0,18,39,57,"17.920000000000002",NA,"West"
"1424","51-9032","Cutting and Slicing Machine Setters, Operators, and Tenders","282",287,5,0.0177,0,13,22,35,"18.09",NA,"West"
"1425","51-9041","Extruding, Forming, Pressing, and Compacting Machine Setters, Operators, and Tenders","484",494,10,0.0207,1,13,36,50,"17.48",NA,"West"
"1426","51-9051","Furnace, Kiln, Oven, Drier, and Kettle Operators and Tenders","110",119,9,0.0818,1,4,7,12,"18.13",NA,"West"
"1427","51-9061","Inspectors, Testers, Sorters, Samplers, and Weighers","3613",3149,-464,-0.1284,-46,130,268,352,"18.09",NA,"West"
"1428","51-9081","Dental Laboratory Technicians","124",122,-2,-0.0161,0,6,10,16,"20.86",NA,"West"
"1429","51-9111","Packaging and Filling Machine Operators and Tenders","1801",1881,80,0.0444,8,76,122,206,"17.63",NA,"West"
"1430","51-9124","Coating, Painting, and Spraying Machine Setters, Operators, and Tenders","977",1051,74,0.0757,7,28,73,108,"18.09",NA,"West"
"1431","51-9161","Computer Numerically Controlled Tool Operators","1915",1895,-20,-0.0104,-2,65,141,204,"21.81",NA,"West"
"1432","51-9162","Computer Numerically Controlled Tool Programmers","302",383,81,0.2682,8,12,25,45,"28.41",NA,"West"
"1433","51-9196","Paper Goods Machine Setters, Operators, and Tenders","723",730,7,0.0097,1,33,48,82,"18.09",NA,"West"
"1434","51-9199","Production Workers, All Other","995",1061,66,0.0663,7,35,76,118,"17.73",NA,"West"
"1435","53-0000","Transportation and Material Moving Occupations","55300",58994,3694,0.0668,369,2602,4510,7481,"17.54",NA,"West"
"1436","53-2012","Commercial Pilots","138",163,25,0.1812,2,6,11,19,"97387","**","West"
"1437","53-3031","Driver/Sales Workers","4298",5158,860,0.2001,86,194,321,601,"10.67",NA,"West"
"1438","53-3032","Heavy and Tractor-Trailer Truck Drivers","10249",10886,637,0.0622,64,433,717,1214,"23.27",NA,"West"
"1439","53-3033","Light Truck or Delivery Services Drivers","3990",4191,201,0.0504,20,168,277,465,"17.690000000000001",NA,"West"
"1440","53-3052","Bus Drivers, Transit and Intercity","369",373,4,0.0108,0,24,18,42,"18.93",NA,"West"
"1441","53-3058","Passenger Vehicle Drivers, Except Bus Drivers, Transit and Intercity","1316",1729,413,0.3138,41,100,76,217,"18.05","^^^","West"
"1442","53-6021","Parking Lot Attendants","286",302,16,0.0559,2,14,30,46,"12.81",NA,"West"
"1443","53-7011","Conveyor Operators and Tenders","109",105,-4,-0.0367,0,3,9,12,"16.079999999999998",NA,"West"
"1444","53-7021","Crane and Tower Operators","168",176,8,0.0476,1,5,13,19,"30.55",NA,"West"
"1445","53-7051","Industrial Truck and Tractor Operators","3163",3369,206,0.0651,21,98,251,370,"18.66",NA,"West"
"1446","53-7061","Cleaners of Vehicles and Equipment","1446",1520,74,0.0512,7,73,132,212,"14.08",NA,"West"
"1447","53-7062","Laborers and Freight, Stock, and Material Movers, Hand","11908",12621,713,0.0599,71,537,1067,1675,"16.420000000000002",NA,"West"
"1448","53-7064","Packers and Packagers, Hand","3533",3435,-98,-0.0277,-10,198,282,470,"13.95",NA,"West"
"1449","53-7065","Stockers and Order Fillers","9342",9669,327,0.035,33,541,927,1501,"14.11",NA,"West"
"1450","53-7081","Refuse and Recyclable Material Collectors","460",501,41,0.0891,4,20,43,67,"18.739999999999998",NA,"West"
"1451","00-0000","Total, All Occupations","345649",359290,13641,0.0395,1364,16034,22919,40317,"17.86",NA,"Southeast"
"1452","11-0000","Management Occupations","31712",33526,1814,0.0572,181,1539,1388,3108,"37.340000000000003",NA,"Southeast"
"1453","11-1011","Chief Executives","195",181,-14,-0.0718,-1,5,8,12,"78.25",NA,"Southeast"
"1454","11-1021","General and Operations Managers","3721",3914,193,0.0519,19,76,237,332,"35.94",NA,"Southeast"
"1455","11-1031","Legislators","321",336,15,0.0467,2,8,16,26,"36208","**","Southeast"
"1456","11-2022","Sales Managers","224",224,0,0,0,4,14,18,"57.28",NA,"Southeast"
"1457","11-3010","Administrative Services and Facilities Managers","467",486,19,0.0407,2,14,24,40,"47.73","^","Southeast"
"1458","11-3021","Computer and Information Systems Managers","151",160,9,0.0596,1,2,9,12,"56.99",NA,"Southeast"
"1459","11-3031","Financial Managers","661",761,100,0.1513,10,15,36,61,"49.32",NA,"Southeast"
"1460","11-3051","Industrial Production Managers","605",620,15,0.0248,2,12,29,43,"47.24",NA,"Southeast"
"1461","11-3071","Transportation, Storage, and Distribution Managers","311",346,35,0.1125,4,6,18,28,"37.340000000000003",NA,"Southeast"
"1462","11-3121","Human Resources Managers","109",114,5,0.0459,0,3,6,9,"56.91",NA,"Southeast"
"1463","11-9013","Farmers, Ranchers, and Other Agricultural Managers","19850",20745,895,0.0451,90,1252,705,2047,"35.119999999999997","^","Southeast"
"1464","11-9021","Construction Managers","562",621,59,0.105,6,12,30,48,"43.49",NA,"Southeast"
"1465","11-9032","Education Administrators, Elementary and Secondary School","809",844,35,0.0433,4,20,38,62,"94315","**","Southeast"
"1466","11-9033","Education Administrators, Postsecondary","235",243,8,0.034,1,6,11,18,"45.96",NA,"Southeast"
"1467","11-9051","Food Service Managers","656",729,73,0.1113,7,21,55,83,"23.35",NA,"Southeast"
"1468","11-9081","Lodging Managers","117",125,8,0.0684,1,5,8,14,"27.8",NA,"Southeast"
"1469","11-9111","Medical and Health Services Managers","897",1128,231,0.2575,23,25,51,99,"38.43",NA,"Southeast"
"1470","11-9141","Property, Real Estate, and Community Association Managers","376",400,24,0.0638,2,15,15,32,"22.38",NA,"Southeast"
"1471","11-9151","Social and Community Service Managers","410",477,67,0.1634,7,13,24,44,"29.01",NA,"Southeast"
"1472","11-9198","Personal Service Managers; Entertainment & Recreation Managers, Except Gambling; and Managers, All Other","408",427,19,0.0466,2,10,20,32,"59.93","^^^","Southeast"
"1473","13-0000","Business and Financial Operations Occupations","9101",9640,539,0.0592,54,250,555,859,"29.17",NA,"Southeast"
"1474","13-1020","Buyers and Purchasing Agents","550",519,-31,-0.0564,-3,18,34,49,"27.85",NA,"Southeast"
"1475","13-1031","Claims Adjusters, Examiners, and Investigators","141",131,-10,-0.0709,-1,3,7,9,"38.6",NA,"Southeast"
"1476","13-1041","Compliance Officers","373",400,27,0.0724,3,9,21,33,"27.21",NA,"Southeast"
"1477","13-1051","Cost Estimators","449",450,1,0.0022,0,13,27,40,"29.11",NA,"Southeast"
"1478","13-1071","Human Resources Specialists","844",886,42,0.0498,4,23,58,85,"27.4",NA,"Southeast"
"1479","13-1075","Labor Relations Specialists","314",270,-44,-0.1401,-4,8,19,23,"30.35",NA,"Southeast"
"1480","13-1081","Logisticians","281",372,91,0.3238,9,7,21,37,"37.03",NA,"Southeast"
"1481","13-1111","Management Analysts","384",451,67,0.1745,7,13,24,44,"36.43",NA,"Southeast"
"1482","13-1121","Meeting, Convention, and Event Planners","164",168,4,0.0244,0,5,12,17,"28.94",NA,"Southeast"
"1483","13-1131","Fundraisers","166",183,17,0.1024,2,5,11,18,"27.36",NA,"Southeast"
"1484","13-1151","Training and Development Specialists","360",397,37,0.1028,4,11,23,38,"23.15",NA,"Southeast"
"1485","13-1161","Market Research Analysts and Marketing Specialists","598",701,103,0.1722,10,15,48,73,"23.76",NA,"Southeast"
"1486","13-1198","Project Management Specialists and Business Operations Specialists, All Other","1422",1488,66,0.0464,7,34,71,112,"35.9","^^^","Southeast"
"1487","13-2011","Accountants and Auditors","1750",1850,100,0.0571,10,50,107,167,"29.66",NA,"Southeast"
"1488","13-2052","Personal Financial Advisors","312",351,39,0.125,4,8,16,28,"35.619999999999997",NA,"Southeast"
"1489","13-2072","Loan Officers","386",387,1,0.0026,0,8,21,29,"30.37",NA,"Southeast"
"1490","13-2098","Financial and Investment Analysts, Financial Risk Specialists, and Financial Specialists, All Other","224",237,13,0.058,1,4,13,18,"35.21","^^^","Southeast"
"1491","15-0000","Computer and Mathematical Occupations","2599",2808,209,0.0804,21,54,134,209,"29.89",NA,"Southeast"
"1492","15-1211","Computer Systems Analysts","218",234,16,0.0734,2,4,11,17,"36.049999999999997",NA,"Southeast"
"1493","15-1231","Computer Network Support Specialists","278",290,12,0.0432,1,5,15,21,"28.9",NA,"Southeast"
"1494","15-1232","Computer User Support Specialists","573",602,29,0.0506,3,11,31,45,"22.44",NA,"Southeast"
"1495","15-1244","Network and Computer Systems Administrators","451",460,9,0.02,1,8,22,31,"36.89",NA,"Southeast"
"1496","15-1256","Software Developers and Software Quality Assurance Analysts and Testers","420",490,70,0.1667,7,11,22,40,"49.49","^^^","Southeast"
"1497","15-1299","Computer Occupations, All Other","173",185,12,0.0694,1,4,9,14,"36.049999999999997",NA,"Southeast"
"1498","17-0000","Architecture and Engineering Occupations","4067",4282,215,0.0529,22,106,212,340,"36.299999999999997",NA,"Southeast"
"1499","17-1022","Surveyors","120",121,1,0.0083,0,4,6,10,"28.02",NA,"Southeast"
"1500","17-2051","Civil Engineers","207",221,14,0.0676,1,4,11,16,"37.619999999999997",NA,"Southeast"
"1501","17-2071","Electrical Engineers","245",245,0,0,0,6,10,16,"44.82",NA,"Southeast"
"1502","17-2111","Health and Safety Engineers, Except Mining Safety Engineers and Inspectors","103",113,10,0.0971,1,2,4,7,"48.98",NA,"Southeast"
"1503","17-2112","Industrial Engineers","575",651,76,0.1322,8,13,24,45,"37.89",NA,"Southeast"
"1504","17-2141","Mechanical Engineers","348",360,12,0.0345,1,6,15,22,"35.85",NA,"Southeast"
"1505","17-2199","Engineers, All Other","128",130,2,0.0156,0,3,5,8,"36.17",NA,"Southeast"
"1506","17-3023","Electrical and Electronics Engineering Technicians","467",476,9,0.0193,1,14,29,44,"28.52",NA,"Southeast"
"1507","17-3026","Industrial Engineering Technicians","216",225,9,0.0417,1,7,14,22,"27.41",NA,"Southeast"
"1508","17-3098","Calibration and Engineering Technologists and Technicians, Except Drafters, All Other","165",167,2,0.0121,0,5,10,15,"29.18","^^^","Southeast"
"1509","19-0000","Life, Physical, and Social Science Occupations","2079",2255,176,0.0847,18,50,142,210,"30.65",NA,"Southeast"
"1510","19-2041","Environmental Scientists and Specialists, Including Health","223",242,19,0.0852,2,4,18,24,"38.9",NA,"Southeast"
"1511","19-3031","Clinical, Counseling, and School Psychologists","180",193,13,0.0722,1,5,7,13,"38.96","^^^","Southeast"
"1512","19-5011","Occupational Health and Safety Specialists","481",565,84,0.1746,8,14,22,44,"35.82",NA,"Southeast"
"1513","19-5012","Occupational Health and Safety Technicians","110",127,17,0.1545,2,3,5,10,"23.08",NA,"Southeast"
"1514","21-0000","Community and Social Service Occupations","6446",7331,885,0.1373,88,226,442,756,"22.03",NA,"Southeast"
"1515","21-1012","Educational, Guidance, School, and Vocational Counselors","922",982,60,0.0651,6,31,56,93,"29.3",NA,"Southeast"
"1516","21-1015","Rehabilitation Counselors","230",248,18,0.0783,2,8,14,24,"17.7",NA,"Southeast"
"1517","21-1018","Substance Abuse, Behavioral Disorder, and Mental Health Counselors","959",1193,234,0.244,23,35,64,122,"22.42",NA,"Southeast"
"1518","21-1021","Child, Family, and School Social Workers","523",585,62,0.1185,6,16,35,57,"21.78",NA,"Southeast"
"1519","21-1022","Healthcare Social Workers","426",476,50,0.1174,5,13,28,46,"23.91",NA,"Southeast"
"1520","21-1023","Mental Health and Substance Abuse Social Workers","682",821,139,0.2038,14,21,48,83,"18.68",NA,"Southeast"
"1521","21-1029","Social Workers, All Other","354",381,27,0.0763,3,10,23,36,"28.54",NA,"Southeast"
"1522","21-1092","Probation Officers and Correctional Treatment Specialists","297",305,8,0.0269,1,6,18,25,"22.96",NA,"Southeast"
"1523","21-1093","Social and Human Service Assistants","1203",1428,225,0.187,22,52,99,173,"14.94",NA,"Southeast"
"1524","21-1099","Community and Social Service Specialists, All Other","181",198,17,0.0939,2,6,13,21,"18.32",NA,"Southeast"
"1525","21-2011","Clergy","335",344,9,0.0269,1,14,20,35,"23.73",NA,"Southeast"
"1526","23-0000","Legal Occupations","1149",1165,16,0.0139,2,33,48,83,"29.38",NA,"Southeast"
"1527","23-1011","Lawyers","393",402,9,0.0229,1,9,10,20,"37.68",NA,"Southeast"
"1528","23-1023","Judges, Magistrate Judges, and Magistrates","257",258,1,0.0039,0,6,6,12,"47.62",NA,"Southeast"
"1529","23-2011","Paralegals and Legal Assistants","330",345,15,0.0455,2,13,23,38,"18.059999999999999",NA,"Southeast"
"1530","25-0000","Education, Training, and Library Occupations","22868",24074,1206,0.0527,121,877,1030,2028,"29.04",NA,"Southeast"
"1531","25-1011","Business Teachers, Postsecondary","224",230,6,0.0268,1,10,11,22,"98831","**","Southeast"
"1532","25-1022","Mathematical Science Teachers, Postsecondary","112",116,4,0.0357,0,5,5,10,"77456","**","Southeast"
"1533","25-1032","Engineering Teachers, Postsecondary","146",158,12,0.0822,1,7,7,15,"99600","**","Southeast"
"1534","25-1042","Biological Science Teachers, Postsecondary","126",137,11,0.0873,1,6,6,13,"77833","**","Southeast"
"1535","25-1066","Psychology Teachers, Postsecondary","122",129,7,0.0574,1,6,6,13,"77629","**","Southeast"
"1536","25-1071","Health Specialties Teachers, Postsecondary","471",553,82,0.1741,8,23,24,55,"82106","**","Southeast"
"1537","25-1072","Nursing Instructors and Teachers, Postsecondary","199",234,35,0.1759,4,10,10,24,"71830","**","Southeast"
"1538","25-1081","Education Teachers, Postsecondary","121",126,5,0.0413,0,6,6,12,"61550","**","Southeast"
"1539","25-1121","Art, Drama, and Music Teachers, Postsecondary","235",246,11,0.0468,1,11,11,23,"61550","**","Southeast"
"1540","25-1122","Communications Teachers, Postsecondary","118",123,5,0.0424,0,5,6,11,"81248","**","Southeast"
"1541","25-1123","English Language and Literature Teachers, Postsecondary","201",208,7,0.0348,1,9,10,20,"63742","**","Southeast"
"1542","25-1193","Recreation and Fitness Studies Teachers, Postsecondary","112",116,4,0.0357,0,5,5,10,"63742","**","Southeast"
"1543","25-1194","Vocational Education Teachers, Postsecondary","265",261,-4,-0.0151,0,12,12,24,"29.13",NA,"Southeast"
"1544","25-1199","Postsecondary Teachers, All Other","234",239,5,0.0214,0,11,11,22,"58917","**","Southeast"
"1545","25-2011","Preschool Teachers, Except Special Education","597",688,91,0.1524,9,26,38,73,"13.75",NA,"Southeast"
"1546","25-2012","Kindergarten Teachers, Except Special Education","161",168,7,0.0435,1,7,10,18,"61006","**","Southeast"
"1547","25-2021","Elementary School Teachers, Except Special Education","5130",5301,171,0.0333,17,160,209,386,"61318","**","Southeast"
"1548","25-2022","Middle School Teachers, Except Special and Career/Technical Education","1892",1954,62,0.0328,6,59,77,142,"62224","**","Southeast"
"1549","25-2031","Secondary School Teachers, Except Special and Career/Technical Education","3528",3659,131,0.0371,13,95,146,254,"61922","**","Southeast"
"1550","25-2032","Career/Technical Education Teachers, Secondary School","860",885,25,0.0291,2,23,35,60,"72486","**","Southeast"
"1551","25-2052","Special Education Teachers, Kindergarten and Elementary School","430",451,21,0.0488,2,14,18,34,"61044","**","Southeast"
"1552","25-2057","Special Education Teachers, Middle School","326",337,11,0.0337,1,11,13,25,"59617","**","Southeast"
"1553","25-2058","Special Education Teachers, Secondary School","616",653,37,0.0601,4,21,25,50,"60902","**","Southeast"
"1554","25-3021","Self-Enrichment Education Teachers","251",316,65,0.259,6,17,15,38,"14.44",NA,"Southeast"
"1555","25-3031","Substitute Teachers, Short-Term","676",730,54,0.0799,5,42,38,85,"14.16",NA,"Southeast"
"1556","25-3097","Teachers and Instructors, All Other, Except Substitute Teachers","332",370,38,0.1145,4,21,19,44,"17.940000000000001","^^^","Southeast"
"1557","25-4022","Librarians and Media Collections Specialists","358",370,12,0.0335,1,18,16,35,"22.95",NA,"Southeast"
"1558","25-4031","Library Technicians","183",172,-11,-0.0601,-1,15,11,25,"13.79",NA,"Southeast"
"1559","25-9031","Instructional Coordinators","484",535,51,0.1054,5,25,22,52,"29.28",NA,"Southeast"
"1560","25-9045","Teaching Assistants, Except Postsecondary","3013",3214,201,0.0667,20,139,146,305,"27396","**","Southeast"
"1561","27-0000","Arts, Design, Entertainment, Sports, and Media Occupations","3127",3215,88,0.0281,9,124,211,344,"17.260000000000002",NA,"Southeast"
"1562","27-1023","Floral Designers","130",101,-29,-0.2231,-3,4,7,8,"12.17",NA,"Southeast"
"1563","27-1024","Graphic Designers","200",199,-1,-0.005,0,6,12,18,"18.61",NA,"Southeast"
"1564","27-1025","Interior Designers","132",124,-8,-0.0606,-1,4,8,11,"22.71",NA,"Southeast"
"1565","27-1026","Merchandise Displayers and Window Trimmers","266",267,1,0.0038,0,8,16,24,"14.19",NA,"Southeast"
"1566","27-2022","Coaches and Scouts","835",882,47,0.0563,5,49,69,123,"29929","**","Southeast"
"1567","27-3011","Radio and Television Announcers","124",110,-14,-0.1129,-1,4,6,9,"11.12",NA,"Southeast"
"1568","27-3023","News Analysts, Reporters, and Journalists","179",163,-16,-0.0894,-2,5,13,16,"14.73",NA,"Southeast"
"1569","27-3031","Public Relations Specialists","275",305,30,0.1091,3,7,19,29,"21.15",NA,"Southeast"
"1570","27-4021","Photographers","181",230,49,0.2707,5,7,12,24,"14.71",NA,"Southeast"
"1571","29-0000","Healthcare Practitioners and Technical Occupations","25156",26880,1724,0.0685,172,672,807,1651,"28.7",NA,"Southeast"
"1572","29-1011","Chiropractors","116",122,6,0.0517,1,2,1,4,"37.61",NA,"Southeast"
"1573","29-1021","Dentists, General","200",200,0,0,0,4,2,6,"78.88",NA,"Southeast"
"1574","29-1041","Optometrists","280",292,12,0.0429,1,5,4,10,"47.53",NA,"Southeast"
"1575","29-1051","Pharmacists","818",779,-39,-0.0477,-4,15,15,26,"60.87",NA,"Southeast"
"1576","29-1071","Physician Assistants","124",159,35,0.2823,4,2,6,12,"57.05",NA,"Southeast"
"1577","29-1122","Occupational Therapists","385",430,45,0.1169,4,9,13,26,"37.32",NA,"Southeast"
"1578","29-1123","Physical Therapists","475",524,49,0.1032,5,10,10,25,"42.41",NA,"Southeast"
"1579","29-1125","Recreational Therapists","101",98,-3,-0.0297,0,3,4,7,"22.29",NA,"Southeast"
"1580","29-1126","Respiratory Therapists","375",453,78,0.208,8,9,10,27,"28.52",NA,"Southeast"
"1581","29-1127","Speech-Language Pathologists","316",390,74,0.2342,7,8,13,28,"35.15",NA,"Southeast"
"1582","29-1131","Veterinarians","229",246,17,0.0742,2,4,4,10,"45.96",NA,"Southeast"
"1583","29-1141","Registered Nurses","7944",8442,498,0.0627,50,219,206,475,"29.47",NA,"Southeast"
"1584","29-1151","Nurse Anesthetists","241",262,21,0.0871,2,5,8,15,"#",NA,"Southeast"
"1585","29-1171","Nurse Practitioners","736",1150,414,0.5625,41,20,30,91,"48.52",NA,"Southeast"
"1586","29-1215","Family Medicine Physicians","197",200,3,0.0152,0,3,2,5,"#",NA,"Southeast"
"1587","29-1228","Physicians, All Other; and Ophthalmologists, Except Pediatric","1166",1182,16,0.0137,2,19,13,34,"37.450000000000003","^^^","Southeast"
"1588","29-1248","Surgeons, Except Ophthalmologists","101",99,-2,-0.0198,0,2,1,3,"# ^^^",NA,"Southeast"
"1589","29-1292","Dental Hygienists","432",439,7,0.0162,1,16,11,28,"29.58",NA,"Southeast"
"1590","29-2010","Clinical Laboratory Technologists and Technicians","560",584,24,0.0429,2,15,21,38,"23.22",NA,"Southeast"
"1591","29-2031","Cardiovascular Technologists and Technicians","181",191,10,0.0552,1,5,8,14,"28.5",NA,"Southeast"
"1592","29-2032","Diagnostic Medical Sonographers","184",212,28,0.1522,3,5,8,16,"29.11",NA,"Southeast"
"1593","29-2034","Radiologic Technologists","498",527,29,0.0582,3,14,22,39,"22.99",NA,"Southeast"
"1594","29-2040","Emergency Medical Technicians and Paramedics","1049",1132,83,0.0791,8,20,50,78,"17.760000000000002","^","Southeast"
"1595","29-2052","Pharmacy Technicians","1216",1236,20,0.0164,2,34,53,89,"14.07",NA,"Southeast"
"1596","29-2055","Surgical Technologists","320",348,28,0.0875,3,9,14,26,"22.06",NA,"Southeast"
"1597","29-2061","Licensed Practical and Licensed Vocational Nurses","3996",4147,151,0.0378,15,137,170,322,"22.15",NA,"Southeast"
"1598","29-2081","Opticians, Dispensing","252",259,7,0.0278,1,11,9,21,"20.79",NA,"Southeast"
"1599","29-2098","Medical Dosimetrists, Medical Records Specialists, and Health Technologists and Technicians, All Other","1012",1054,42,0.0415,4,28,44,76,"22.55","^^^","Southeast"
"1600","31-0000","Healthcare Support Occupations","17455",19734,2279,0.1306,228,1104,1138,2470,"13.67",NA,"Southeast"
"1601","31-1120","Home Health and Personal Care Aides","7980",9904,1924,0.2411,192,572,506,1270,"11.15",NA,"Southeast"
"1602","31-1131","Nursing Assistants","4979",4824,-155,-0.0311,-16,314,278,576,"13.88",NA,"Southeast"
"1603","31-2011","Occupational Therapy Assistants","268",325,57,0.2127,6,15,22,43,"28.55",NA,"Southeast"
"1604","31-2021","Physical Therapist Assistants","444",566,122,0.2748,12,22,38,72,"28.9",NA,"Southeast"
"1605","31-9011","Massage Therapists","207",250,43,0.2077,4,13,12,29,"18.47",NA,"Southeast"
"1606","31-9091","Dental Assistants","614",627,13,0.0212,1,28,44,73,"17.79",NA,"Southeast"
"1607","31-9092","Medical Assistants","1669",1922,253,0.1516,25,74,134,233,"14.47",NA,"Southeast"
"1608","31-9095","Pharmacy Aides","109",83,-26,-0.2385,-3,5,7,9,"13.08",NA,"Southeast"
"1609","31-9096","Veterinary Assistants and Laboratory Animal Caretakers","335",352,17,0.0507,2,17,38,57,"13.36",NA,"Southeast"
"1610","31-9097","Phlebotomists","345",368,23,0.0667,2,15,26,43,"14.34",NA,"Southeast"
"1611","31-9099","Healthcare Support Workers, All Other","155",154,-1,-0.0065,0,9,10,19,"14.34",NA,"Southeast"
"1612","33-0000","Protective Service Occupations","6961",6877,-84,-0.0121,-8,261,396,649,"22.81",NA,"Southeast"
"1613","33-1012","First-Line Supervisors of Police and Detectives","169",174,5,0.0296,0,4,7,11,"37.340000000000003",NA,"Southeast"
"1614","33-1021","First-Line Supervisors of Fire Fighting and Prevention Workers","102",107,5,0.049,0,2,4,6,"29.09",NA,"Southeast"
"1615","33-2011","Firefighters","1073",1141,68,0.0634,7,24,57,88,"22.19",NA,"Southeast"
"1616","33-3012","Correctional Officers and Jailers","2219",1946,-273,-0.123,-27,78,113,164,"22.81",NA,"Southeast"
"1617","33-3051","Police and Sheriff's Patrol Officers","1795",1854,59,0.0329,6,46,93,145,"28.86",NA,"Southeast"
"1618","33-9032","Security Guards","893",930,37,0.0414,4,48,71,123,"13.76",NA,"Southeast"
"1619","33-9092","Lifeguards, Ski Patrol, and Other Recreational Protective Service Workers","107",117,10,0.0935,1,15,12,28,"10.39",NA,"Southeast"
"1620","33-9098","School Bus Monitors and Protective Service Workers, All Other","134",138,4,0.0299,0,19,15,34,"15.11","^^^","Southeast"
"1621","35-0000","Food Preparation and Serving Related Occupations","29427",32677,3250,0.1104,325,2435,3157,5917,"10.6",NA,"Southeast"
"1622","35-1012","First-Line Supervisors of Food Preparation and Serving Workers","2629",3035,406,0.1544,41,126,289,456,"14.39",NA,"Southeast"
"1623","35-2011","Cooks, Fast Food","870",811,-59,-0.0678,-6,50,72,116,"10.42",NA,"Southeast"
"1624","35-2012","Cooks, Institution and Cafeteria","2176",2145,-31,-0.0142,-3,127,185,309,"13.57",NA,"Southeast"
"1625","35-2014","Cooks, Restaurant","2096",2950,854,0.4074,85,148,216,449,"13.18",NA,"Southeast"
"1626","35-2015","Cooks, Short Order","197",217,20,0.1015,2,12,18,32,"11.31",NA,"Southeast"
"1627","35-2021","Food Preparation Workers","1959",2043,84,0.0429,8,157,184,349,"10.42",NA,"Southeast"
"1628","35-3011","Bartenders","808",945,137,0.1696,14,40,106,160,"9.9700000000000006",NA,"Southeast"
"1629","35-3023","Fast Food and Counter Workers","12076",13094,1018,0.0843,102,1220,1330,2652,"10.26",NA,"Southeast"
"1630","35-3031","Waiters and Waitresses","3957",4479,522,0.1319,52,310,504,866,"9.68",NA,"Southeast"
"1631","35-3041","Food Servers, Nonrestaurant","717",712,-5,-0.007,0,56,56,112,"11.09",NA,"Southeast"
"1632","35-9011","Dining Room and Cafeteria Attendants and Bartender Helpers","239",295,56,0.2343,6,23,23,52,"10.72",NA,"Southeast"
"1633","35-9021","Dishwashers","621",703,82,0.132,8,50,55,113,"10.42",NA,"Southeast"
"1634","35-9031","Hosts and Hostesses, Restaurant, Lounge, and Coffee Shop","613",717,104,0.1697,10,79,75,164,"10.34",NA,"Southeast"
"1635","35-9099","Food Preparation and Serving Related Workers, All Other","313",377,64,0.2045,6,30,30,66,"10.26",NA,"Southeast"
"1636","37-0000","Building and Grounds Cleaning and Maintenance Occupations","11000",11465,465,0.0423,46,642,821,1509,"13.95",NA,"Southeast"
"1637","37-1011","First-Line Supervisors of Housekeeping and Janitorial Workers","383",384,1,0.0026,0,16,26,42,"18.64",NA,"Southeast"
"1638","37-1012","First-Line Supervisors of Landscaping, Lawn Service, and Groundskeeping Workers","174",177,3,0.0172,0,5,13,18,"23.33",NA,"Southeast"
"1639","37-2011","Janitors and Cleaners, Except Maids and Housekeeping Cleaners","4812",4975,163,0.0339,16,305,343,664,"14.3",NA,"Southeast"
"1640","37-2012","Maids and Housekeeping Cleaners","2645",2739,94,0.0355,9,183,173,365,"11.15",NA,"Southeast"
"1641","37-3011","Landscaping and Groundskeeping Workers","2875",3073,198,0.0689,20,128,255,403,"14.3",NA,"Southeast"
"1642","39-0000","Personal Care and Service Occupations","6227",6462,235,0.0377,24,391,494,909,"12.8",NA,"Southeast"
"1643","39-1098","First-Line Supervisors of Personal Service & Entertainment and Recreation Workers, Exc Gambling Services","283",311,28,0.0989,3,11,21,35,"21.67","^^^","Southeast"
"1644","39-3091","Amusement and Recreation Attendants","393",453,60,0.1527,6,41,47,94,"10.38",NA,"Southeast"
"1645","39-4021","Funeral Attendants","332",334,2,0.006,0,19,25,44,"13.85",NA,"Southeast"
"1646","39-5012","Hairdressers, Hairstylists, and Cosmetologists","1354",1264,-90,-0.0665,-9,69,73,133,"10.99",NA,"Southeast"
"1647","39-9011","Childcare Workers","1298",1286,-12,-0.0092,-1,87,90,176,"10.97",NA,"Southeast"
"1648","39-9032","Recreation Workers","880",907,27,0.0307,3,52,85,140,"13.52",NA,"Southeast"
"1649","41-0000","Sales and Related Occupations","30773",29126,-1647,-0.0535,-165,1724,2464,4023,"13.02",NA,"Southeast"
"1650","41-1011","First-Line Supervisors of Retail Sales Workers","3439",3169,-270,-0.0785,-27,117,229,319,"17.82",NA,"Southeast"
"1651","41-1012","First-Line Supervisors of Non-Retail Sales Workers","381",352,-29,-0.0761,-3,11,22,30,"35.04",NA,"Southeast"
"1652","41-2011","Cashiers","10405",9227,-1178,-0.1132,-118,835,940,1657,"10.69",NA,"Southeast"
"1653","41-2022","Parts Salespersons","837",857,20,0.0239,2,36,65,103,"14.04",NA,"Southeast"
"1654","41-2031","Retail Salespersons","8960",8771,-189,-0.0211,-19,496,732,1209,"11.6",NA,"Southeast"
"1655","41-3011","Advertising Sales Agents","155",141,-14,-0.0903,-1,4,14,17,"16.34",NA,"Southeast"
"1656","41-3021","Insurance Sales Agents","937",920,-17,-0.0181,-2,31,52,81,"18.440000000000001",NA,"Southeast"
"1657","41-3031","Securities, Commodities, and Financial Services Sales Agents","391",407,16,0.0409,2,9,25,36,"22.82",NA,"Southeast"
"1658","41-3091","Sales Representatives of Services, Except Advertising, Insurance, Financial Services, and Travel","955",1040,85,0.089,8,25,88,121,"23.18",NA,"Southeast"
"1659","41-4011","Sales Representatives, Wholesale and Manufacturing, Technical and Scientific Products","132",144,12,0.0909,1,4,9,14,"47.13",NA,"Southeast"
"1660","41-4012","Sales Representatives, Wholesale and Manufacturing, Except Technical and Scientific Products","1995",2035,40,0.0201,4,60,136,200,"26.96",NA,"Southeast"
"1661","41-9022","Real Estate Sales Agents","512",541,29,0.0566,3,22,23,48,"17.670000000000002",NA,"Southeast"
"1662","43-0000","Office and Administrative Support Occupations","39074",37413,-1661,-0.0425,-166,1850,2301,3985,"17.47",NA,"Southeast"
"1663","43-1011","First-Line Supervisors of Office and Administrative Support Workers","2284",2177,-107,-0.0468,-11,83,136,208,"22.97",NA,"Southeast"
"1664","43-3011","Bill and Account Collectors","162",148,-14,-0.0864,-1,6,11,16,"17.739999999999998",NA,"Southeast"
"1665","43-3021","Billing and Posting Clerks","1388",1414,26,0.0187,3,58,86,147,"17.739999999999998",NA,"Southeast"
"1666","43-3031","Bookkeeping, Accounting, and Auditing Clerks","3620",3510,-110,-0.0304,-11,209,182,380,"17.899999999999999",NA,"Southeast"
"1667","43-3051","Payroll and Timekeeping Clerks","313",278,-35,-0.1118,-4,14,16,26,"18.21",NA,"Southeast"
"1668","43-3071","Tellers","1767",1468,-299,-0.1692,-30,66,102,138,"14.13",NA,"Southeast"
"1669","43-4031","Court, Municipal, and License Clerks","1405",1484,79,0.0562,8,70,73,151,"17.690000000000001",NA,"Southeast"
"1670","43-4051","Customer Service Representatives","3730",3480,-250,-0.067,-25,170,284,429,"16.32",NA,"Southeast"
"1671","43-4061","Eligibility Interviewers, Government Programs","242",249,7,0.0289,1,9,13,23,"22.35",NA,"Southeast"
"1672","43-4071","File Clerks","142",121,-21,-0.1479,-2,7,8,13,"14.36",NA,"Southeast"
"1673","43-4081","Hotel, Motel, and Resort Desk Clerks","465",547,82,0.1763,8,29,54,91,"10.97",NA,"Southeast"
"1674","43-4111","Interviewers, Except Eligibility and Loan","419",362,-57,-0.136,-6,23,25,42,"14.32",NA,"Southeast"
"1675","43-4121","Library Assistants, Clerical","378",358,-20,-0.0529,-2,33,24,55,"10.85",NA,"Southeast"
"1676","43-4131","Loan Interviewers and Clerks","376",367,-9,-0.0239,-1,11,22,32,"17.899999999999999",NA,"Southeast"
"1677","43-4151","Order Clerks","178",143,-35,-0.1966,-4,7,10,13,"17.739999999999998",NA,"Southeast"
"1678","43-4161","Human Resources Assistants, Except Payroll and Timekeeping","174",163,-11,-0.0632,-1,6,10,15,"17.91",NA,"Southeast"
"1679","43-4171","Receptionists and Information Clerks","2144",2151,7,0.0033,1,120,148,269,"13.67",NA,"Southeast"
"1680","43-4199","Information and Record Clerks, All Other","177",186,9,0.0508,1,7,12,20,"18.29",NA,"Southeast"
"1681","43-5021","Couriers and Messengers","208",197,-11,-0.0529,-1,8,11,18,"13.58",NA,"Southeast"
"1682","43-5031","Police, Fire, and Ambulance Dispatchers","386",401,15,0.0389,2,14,22,38,"18.420000000000002",NA,"Southeast"
"1683","43-5032","Dispatchers, Except Police, Fire, and Ambulance","500",518,18,0.036,2,18,28,48,"17.91",NA,"Southeast"
"1684","43-5051","Postal Service Clerks","378",344,-34,-0.0899,-3,16,13,26,"25.12",NA,"Southeast"
"1685","43-5052","Postal Service Mail Carriers","1161",1054,-107,-0.0922,-11,38,40,67,"23.3",NA,"Southeast"
"1686","43-5061","Production, Planning, and Expediting Clerks","710",741,31,0.0437,3,26,47,76,"23.23",NA,"Southeast"
"1687","43-5071","Shipping, Receiving, and Traffic Clerks","1500",1385,-115,-0.0767,-12,53,85,126,"17.48",NA,"Southeast"
"1688","43-5111","Weighers, Measurers, Checkers, and Samplers, Recordkeeping","173",189,16,0.0925,2,7,10,19,"18.190000000000001",NA,"Southeast"
"1689","43-6011","Executive Secretaries and Executive Administrative Assistants","437",354,-83,-0.1899,-8,20,22,34,"23.36",NA,"Southeast"
"1690","43-6012","Legal Secretaries","187",138,-49,-0.262,-5,8,9,12,"17.690000000000001",NA,"Southeast"
"1691","43-6013","Medical Secretaries","1815",1943,128,0.0705,13,96,105,214,"14.36",NA,"Southeast"
"1692","43-6014","Secretaries and Administrative Assistants, Except Legal, Medical, and Executive","3751",3402,-349,-0.093,-35,182,200,347,"17.38",NA,"Southeast"
"1693","43-9021","Data Entry Keyers","209",164,-45,-0.2153,-4,8,12,16,"15.11",NA,"Southeast"
"1694","43-9041","Insurance Claims and Policy Processing Clerks","185",185,0,0,0,6,11,17,"18.059999999999999",NA,"Southeast"
"1695","43-9051","Mail Clerks and Mail Machine Operators, Except Postal Service","133",118,-15,-0.1128,-2,6,8,12,"14.19",NA,"Southeast"
"1696","43-9061","Office Clerks, General","7231",7007,-224,-0.031,-22,388,422,788,"16.66",NA,"Southeast"
"1697","45-0000","Farming, Fishing, and Forestry Occupations","3550",3689,139,0.0392,14,150,411,575,"17.649999999999999",NA,"Southeast"
"1698","45-1011","First-Line Supervisors of Farming, Fishing, and Forestry Workers","140",152,12,0.0857,1,5,15,21,"29.36",NA,"Southeast"
"1699","45-2091","Agricultural Equipment Operators","264",300,36,0.1364,4,12,32,48,"21.85","†","Southeast"
"1700","45-2092","Farmworkers and Laborers, Crop, Nursery, and Greenhouse","2390",2501,111,0.0464,11,104,280,395,"14.13",NA,"Southeast"
"1701","45-2093","Farmworkers, Farm, Ranch, and Aquacultural Animals","255",232,-23,-0.0902,-2,10,28,36,"13.5",NA,"Southeast"
"1702","45-4022","Logging Equipment Operators","120",127,7,0.0583,1,4,14,19,"18.28",NA,"Southeast"
"1703","47-0000","Construction and Extraction Occupations","18388",19485,1097,0.0597,110,569,1320,1999,"22.74",NA,"Southeast"
"1704","47-1011","First-Line Supervisors of Construction Trades and Extraction Workers","1342",1464,122,0.0909,12,40,91,143,"29.98",NA,"Southeast"
"1705","47-2021","Brickmasons and Blockmasons","122",121,-1,-0.0082,0,4,8,12,"28.13",NA,"Southeast"
"1706","47-2031","Carpenters","2582",2571,-11,-0.0043,-1,75,161,235,"22.48",NA,"Southeast"
"1707","47-2051","Cement Masons and Concrete Finishers","635",635,0,0,0,15,42,57,"22.37",NA,"Southeast"
"1708","47-2061","Construction Laborers","4584",5014,430,0.0938,43,142,324,509,"18.29",NA,"Southeast"
"1709","47-2071","Paving, Surfacing, and Tamping Equipment Operators","117",123,6,0.0513,1,4,9,14,"23.01",NA,"Southeast"
"1710","47-2073","Operating Engineers and Other Construction Equipment Operators","2326",2403,77,0.0331,8,77,170,255,"22.83",NA,"Southeast"
"1711","47-2111","Electricians","1071",1131,60,0.056,6,32,81,119,"26.66",NA,"Southeast"
"1712","47-2141","Painters, Construction and Maintenance","328",347,19,0.0579,2,10,19,31,"17.940000000000001",NA,"Southeast"
"1713","47-2152","Plumbers, Pipefitters, and Steamfitters","668",677,9,0.0135,1,20,48,69,"28.38",NA,"Southeast"
"1714","47-2181","Roofers","243",257,14,0.0576,1,6,18,25,"18.18",NA,"Southeast"
"1715","47-4041","Hazardous Materials Removal Workers","622",641,19,0.0305,2,24,51,77,"37.32",NA,"Southeast"
"1716","47-4051","Highway Maintenance Workers","1023",1059,36,0.0352,4,41,65,110,"18.100000000000001",NA,"Southeast"
"1717","47-4071","Septic Tank Servicers and Sewer Pipe Cleaners","185",211,26,0.1405,3,6,16,25,"17.87",NA,"Southeast"
"1718","47-5013","Service Unit Operators, Oil, Gas, and Mining","443",544,101,0.228,10,10,48,68,"22.56",NA,"Southeast"
"1719","47-5071","Roustabouts, Oil and Gas","335",433,98,0.2925,10,8,37,55,"14.31",NA,"Southeast"
"1720","49-0000","Installation, Maintenance, and Repair Occupations","15692",16471,779,0.0496,78,504,1016,1598,"22.42",NA,"Southeast"
"1721","49-1011","First-Line Supervisors of Mechanics, Installers, and Repairers","1053",1096,43,0.0408,4,31,64,99,"31.08",NA,"Southeast"
"1722","49-2022","Telecommunications Equipment Installers and Repairers, Except Line Installers","413",445,32,0.0775,3,15,33,51,"28.9",NA,"Southeast"
"1723","49-3021","Automotive Body and Related Repairers","378",369,-9,-0.0238,-1,12,22,33,"21.42",NA,"Southeast"
"1724","49-3023","Automotive Service Technicians and Mechanics","1929",1861,-68,-0.0353,-7,56,129,178,"17.93",NA,"Southeast"
"1725","49-3031","Bus and Truck Mechanics and Diesel Engine Specialists","1382",1524,142,0.1027,14,41,91,146,"22.42",NA,"Southeast"
"1726","49-3041","Farm Equipment Mechanics and Service Technicians","124",140,16,0.129,2,4,9,15,"17.73",NA,"Southeast"
"1727","49-3042","Mobile Heavy Equipment Mechanics, Except Engines","363",387,24,0.0661,2,11,25,38,"23.28",NA,"Southeast"
"1728","49-3093","Tire Repairers and Changers","280",288,8,0.0286,1,9,24,34,"13.81",NA,"Southeast"
"1729","49-9012","Control and Valve Installers and Repairers, Except Mechanical Door","189",187,-2,-0.0106,0,4,11,15,"30.13",NA,"Southeast"
"1730","49-9021","Heating, Air Conditioning, and Refrigeration Mechanics and Installers","993",1015,22,0.0222,2,26,68,96,"22.52",NA,"Southeast"
"1731","49-9031","Home Appliance Repairers","111",111,0,0,0,4,6,10,"18.02",NA,"Southeast"
"1732","49-9041","Industrial Machinery Mechanics","1450",1681,231,0.1593,23,48,85,156,"28.14",NA,"Southeast"
"1733","49-9043","Maintenance Workers, Machinery","151",168,17,0.1126,2,5,9,16,"37.299999999999997",NA,"Southeast"
"1734","49-9044","Millwrights","302",335,33,0.1093,3,9,18,30,"30.07",NA,"Southeast"
"1735","49-9051","Electrical Power-Line Installers and Repairers","448",435,-13,-0.029,-1,8,30,37,"37.020000000000003",NA,"Southeast"
"1736","49-9052","Telecommunications Line Installers and Repairers","234",266,32,0.1368,3,6,21,30,"23.2",NA,"Southeast"
"1737","49-9071","Maintenance and Repair Workers, General","4072",4269,197,0.0484,20,147,243,410,"18.78",NA,"Southeast"
"1738","49-9098","Helpers--Installation, Maintenance, and Repair Workers","375",390,15,0.04,2,16,32,50,"16.93",NA,"Southeast"
"1739","49-9099","Installation, Maintenance, and Repair Workers, All Other","359",371,12,0.0334,1,13,24,38,"18.39",NA,"Southeast"
"1740","51-0000","Production Occupations","27737",26963,-774,-0.0279,-77,1000,1941,2864,"17.920000000000002",NA,"Southeast"
"1741","51-1011","First-Line Supervisors of Production and Operating Workers","1951",1946,-5,-0.0026,0,59,131,190,"29.22",NA,"Southeast"
"1742","51-2028","Electrical, Electronic, and Electromechanical Assemblers, Except Coil Winders, Tapers, and Finishers","160",154,-6,-0.0375,-1,6,10,15,"14.42",NA,"Southeast"
"1743","51-2090","Miscellaneous Assemblers and Fabricators","3152",2959,-193,-0.0612,-19,117,218,316,"16.96",NA,"Southeast"
"1744","51-3011","Bakers","273",269,-4,-0.0147,0,15,20,35,"13.44",NA,"Southeast"
"1745","51-3021","Butchers and Meat Cutters","639",588,-51,-0.0798,-5,25,46,66,"13.73",NA,"Southeast"
"1746","51-3092","Food Batchmakers","1141",1099,-42,-0.0368,-4,52,84,132,"18.05",NA,"Southeast"
"1747","51-4021","Extruding and Drawing Machine Setters, Operators, and Tenders, Metal and Plastic","300",277,-23,-0.0767,-2,10,18,26,"18.12",NA,"Southeast"
"1748","51-4023","Rolling Machine Setters, Operators, and Tenders, Metal and Plastic","269",242,-27,-0.1004,-3,9,16,22,"18.350000000000001",NA,"Southeast"
"1749","51-4031","Cutting, Punching, and Press Machine Setters, Operators, and Tenders, Metal and Plastic","525",500,-25,-0.0476,-2,16,35,49,"17.100000000000001",NA,"Southeast"
"1750","51-4033","Grinding, Lapping, Polishing, and Buffing Machine Tool Setters, Operators, and Tenders, Metal and Plastic","289",292,3,0.0104,0,13,20,33,"17.48",NA,"Southeast"
"1751","51-4035","Milling and Planing Machine Setters, Operators, and Tenders, Metal and Plastic","163",134,-29,-0.1779,-3,5,10,12,"23.54",NA,"Southeast"
"1752","51-4041","Machinists","1091",1109,18,0.0165,2,37,75,114,"18.21",NA,"Southeast"
"1753","51-4072","Molding, Coremaking, and Casting Machine Setters, Operators, and Tenders, Metal and Plastic","500",486,-14,-0.028,-1,16,33,48,"17.47",NA,"Southeast"
"1754","51-4111","Tool and Die Makers","121",115,-6,-0.0496,-1,4,7,10,"23.21",NA,"Southeast"
"1755","51-4121","Welders, Cutters, Solderers, and Brazers","1027",1089,62,0.0604,6,28,84,118,"19.05",NA,"Southeast"
"1756","51-4191","Heat Treating Equipment Setters, Operators, and Tenders, Metal and Plastic","116",103,-13,-0.1121,-1,4,7,10,"22.76",NA,"Southeast"
"1757","51-5112","Printing Press Operators","399",371,-28,-0.0702,-3,14,27,38,"17.27",NA,"Southeast"
"1758","51-5113","Print Binding and Finishing Workers","127",107,-20,-0.1575,-2,6,7,11,"17.38",NA,"Southeast"
"1759","51-6011","Laundry and Dry-Cleaning Workers","423",449,26,0.0615,3,28,29,60,"11.07",NA,"Southeast"
"1760","51-6031","Sewing Machine Operators","293",272,-21,-0.0717,-2,17,15,30,"13.8",NA,"Southeast"
"1761","51-7011","Cabinetmakers and Bench Carpenters","717",787,70,0.0976,7,28,42,77,"17.29",NA,"Southeast"
"1762","51-7041","Sawing Machine Setters, Operators, and Tenders, Wood","456",454,-2,-0.0044,0,16,35,51,"17.84",NA,"Southeast"
"1763","51-7042","Woodworking Machine Setters, Operators, and Tenders, Except Sawing","764",784,20,0.0262,2,23,56,81,"17.440000000000001",NA,"Southeast"
"1764","51-8013","Power Plant Operators","412",322,-90,-0.2184,-9,10,25,26,"37.909999999999997",NA,"Southeast"
"1765","51-8031","Water and Wastewater Treatment Plant and System Operators","498",473,-25,-0.0502,-2,14,30,42,"22.49",NA,"Southeast"
"1766","51-8091","Chemical Plant and System Operators","162",146,-16,-0.0988,-2,4,12,14,"46.67",NA,"Southeast"
"1767","51-9011","Chemical Equipment Operators and Tenders","506",434,-72,-0.1423,-7,10,36,39,"22.63",NA,"Southeast"
"1768","51-9021","Crushing, Grinding, and Polishing Machine Setters, Operators, and Tenders","112",104,-8,-0.0714,-1,4,8,11,"21.52",NA,"Southeast"
"1769","51-9023","Mixing and Blending Machine Setters, Operators, and Tenders","387",388,1,0.0026,0,13,29,42,"18.05",NA,"Southeast"
"1770","51-9032","Cutting and Slicing Machine Setters, Operators, and Tenders","327",285,-42,-0.1284,-4,14,23,33,"18.04",NA,"Southeast"
"1771","51-9041","Extruding, Forming, Pressing, and Compacting Machine Setters, Operators, and Tenders","879",828,-51,-0.058,-5,23,63,81,"18.05",NA,"Southeast"
"1772","51-9061","Inspectors, Testers, Sorters, Samplers, and Weighers","1275",1090,-185,-0.1451,-18,45,94,121,"19.98",NA,"Southeast"
"1773","51-9111","Packaging and Filling Machine Operators and Tenders","1562",1571,9,0.0058,1,65,104,170,"17.12",NA,"Southeast"
"1774","51-9124","Coating, Painting, and Spraying Machine Setters, Operators, and Tenders","579",622,43,0.0743,4,17,43,64,"17.71",NA,"Southeast"
"1775","51-9161","Computer Numerically Controlled Tool Operators","710",644,-66,-0.093,-7,23,50,66,"18.2",NA,"Southeast"
"1776","51-9192","Cleaning, Washing, and Metal Pickling Equipment Operators and Tenders","124",136,12,0.0968,1,4,10,15,"28.27",NA,"Southeast"
"1777","51-9193","Cooling and Freezing Equipment Operators and Tenders","299",316,17,0.0569,2,10,23,35,"22.81","†","Southeast"
"1778","51-9195","Molders, Shapers, and Casters, Except Metal and Plastic","230",260,30,0.1304,3,9,16,28,"17.010000000000002",NA,"Southeast"
"1779","51-9196","Paper Goods Machine Setters, Operators, and Tenders","526",483,-43,-0.0817,-4,23,34,53,"18.2",NA,"Southeast"
"1780","51-9198","Helpers--Production Workers","298",282,-16,-0.0537,-2,14,27,39,"16.37",NA,"Southeast"
"1781","51-9199","Production Workers, All Other","299",305,6,0.0201,1,10,22,33,"17.86",NA,"Southeast"
"1782","53-0000","Transportation and Material Moving Occupations","31061",33752,2691,0.0866,269,1474,2492,4235,"17.34",NA,"Southeast"
"1783","53-1047","FirstLine Supervisors of Transportation & Material Moving Workers, Exc Aircraft Cargo Handling Supervisor","1374",1414,40,0.0291,4,51,97,152,"22.63",NA,"Southeast"
"1784","53-3031","Driver/Sales Workers","2595",2933,338,0.1303,34,113,187,334,"10.52",NA,"Southeast"
"1785","53-3032","Heavy and Tractor-Trailer Truck Drivers","7123",7842,719,0.1009,72,306,507,885,"22.73",NA,"Southeast"
"1786","53-3033","Light Truck or Delivery Services Drivers","2260",2450,190,0.0841,19,96,160,275,"17.010000000000002",NA,"Southeast"
"1787","53-3058","Passenger Vehicle Drivers, Except Bus Drivers, Transit and Intercity","1540",2064,524,0.3403,52,119,90,261,"18.05","^^^","Southeast"
"1788","53-3099","Motor Vehicle Operators, All Other","101",107,6,0.0594,1,10,6,17,"17.100000000000001",NA,"Southeast"
"1789","53-5011","Sailors and Marine Oilers","131",142,11,0.084,1,4,12,17,"18.12",NA,"Southeast"
"1790","53-6031","Automotive and Watercraft Service Attendants","325",303,-22,-0.0677,-2,14,28,40,"11.27",NA,"Southeast"
"1791","53-7021","Crane and Tower Operators","163",165,2,0.0123,0,4,12,16,"28.9",NA,"Southeast"
"1792","53-7051","Industrial Truck and Tractor Operators","1534",1570,36,0.0235,4,47,119,170,"18.36",NA,"Southeast"
"1793","53-7061","Cleaners of Vehicles and Equipment","818",822,4,0.0049,0,40,73,113,"13.56",NA,"Southeast"
"1794","53-7062","Laborers and Freight, Stock, and Material Movers, Hand","5657",6100,443,0.0783,44,257,512,813,"15.71",NA,"Southeast"
"1795","53-7063","Machine Feeders and Offbearers","100",99,-1,-0.01,0,6,7,13,"20.86",NA,"Southeast"
"1796","53-7064","Packers and Packagers, Hand","929",987,58,0.0624,6,55,78,139,"13.28",NA,"Southeast"
"1797","53-7065","Stockers and Order Fillers","4836",4984,148,0.0306,15,280,479,774,"13.73",NA,"Southeast"
"1798","53-7081","Refuse and Recyclable Material Collectors","444",551,107,0.241,11,21,45,77,"18.079999999999998",NA,"Southeast"
"1799","00-0000","Total, All Occupations","576227",591855,15628,0.0271,1563,25435,38747,65745,"18.239999999999998",NA,"Northwest"
"1800","11-0000","Management Occupations","36362",38459,2097,0.0577,210,1416,1753,3379,"45.52",NA,"Northwest"
"1801","11-1011","Chief Executives","597",539,-58,-0.0972,-6,16,23,33,"78",NA,"Northwest"
"1802","11-1021","General and Operations Managers","6254",6601,347,0.0555,35,128,398,561,"38.04",NA,"Northwest"
"1803","11-1031","Legislators","190",195,5,0.0263,0,4,9,13,"36749","**","Northwest"
"1804","11-2021","Marketing Managers","461",494,33,0.0716,3,10,30,43,"60.82",NA,"Northwest"
"1805","11-2022","Sales Managers","721",755,34,0.0472,3,15,46,64,"58.61",NA,"Northwest"
"1806","11-2030","Public Relations and Fundraising Managers","126",132,6,0.0476,1,3,7,11,"57.62","^","Northwest"
"1807","11-3010","Administrative Services and Facilities Managers","1026",1071,45,0.0439,4,30,52,86,"47.73","^","Northwest"
"1808","11-3021","Computer and Information Systems Managers","640",674,34,0.0531,3,11,37,51,"59.43",NA,"Northwest"
"1809","11-3031","Financial Managers","1573",1751,178,0.1132,18,34,84,136,"57.7",NA,"Northwest"
"1810","11-3051","Industrial Production Managers","1513",1602,89,0.0588,9,30,74,113,"47.78",NA,"Northwest"
"1811","11-3061","Purchasing Managers","176",194,18,0.1023,2,4,10,16,"57.73",NA,"Northwest"
"1812","11-3071","Transportation, Storage, and Distribution Managers","630",671,41,0.0651,4,12,36,52,"44.96",NA,"Northwest"
"1813","11-3121","Human Resources Managers","302",320,18,0.0596,2,7,17,26,"55.85",NA,"Northwest"
"1814","11-9013","Farmers, Ranchers, and Other Agricultural Managers","14229",14872,643,0.0452,64,898,506,1468,"35.119999999999997","^","Northwest"
"1815","11-9021","Construction Managers","1062",1165,103,0.097,10,23,56,89,"46.2",NA,"Northwest"
"1816","11-9031","Education Administrators, Preschool and Childcare Center/Program","144",156,12,0.0833,1,4,7,12,"22.1",NA,"Northwest"
"1817","11-9032","Education Administrators, Elementary and Secondary School","952",1007,55,0.0578,6,24,46,76,"94122","**","Northwest"
"1818","11-9033","Education Administrators, Postsecondary","387",372,-15,-0.0388,-2,9,18,25,"46.39",NA,"Northwest"
"1819","11-9041","Architectural and Engineering Managers","431",454,23,0.0534,2,8,22,32,"60.7",NA,"Northwest"
"1820","11-9051","Food Service Managers","656",705,49,0.0747,5,21,54,80,"23.25",NA,"Northwest"
"1821","11-9111","Medical and Health Services Managers","1410",1741,331,0.2348,33,39,80,152,"45.44",NA,"Northwest"
"1822","11-9141","Property, Real Estate, and Community Association Managers","878",877,-1,-0.0011,0,33,33,66,"22.62",NA,"Northwest"
"1823","11-9151","Social and Community Service Managers","448",482,34,0.0759,3,14,25,42,"29.36",NA,"Northwest"
"1824","11-9198","Personal Service Managers; Entertainment & Recreation Managers, Except Gambling; and Managers, All Other","1090",1149,59,0.0541,6,26,55,87,"59.93","^^^","Northwest"
"1825","13-0000","Business and Financial Operations Occupations","23088",24269,1181,0.0512,118,627,1414,2159,"29.49",NA,"Northwest"
"1826","13-1020","Buyers and Purchasing Agents","1282",1219,-63,-0.0491,-6,42,80,116,"29.12",NA,"Northwest"
"1827","13-1031","Claims Adjusters, Examiners, and Investigators","689",644,-45,-0.0653,-4,16,35,47,"29.96",NA,"Northwest"
"1828","13-1041","Compliance Officers","619",646,27,0.0436,3,15,34,52,"28.9",NA,"Northwest"
"1829","13-1051","Cost Estimators","824",822,-2,-0.0024,0,23,50,73,"29.92",NA,"Northwest"
"1830","13-1071","Human Resources Specialists","2841",3123,282,0.0993,28,81,198,307,"28.2",NA,"Northwest"
"1831","13-1075","Labor Relations Specialists","715",622,-93,-0.1301,-9,18,44,53,"30.32",NA,"Northwest"
"1832","13-1081","Logisticians","596",809,213,0.3574,21,15,46,82,"36",NA,"Northwest"
"1833","13-1111","Management Analysts","851",942,91,0.1069,9,29,52,90,"36.869999999999997",NA,"Northwest"
"1834","13-1121","Meeting, Convention, and Event Planners","235",259,24,0.1021,2,7,18,27,"22.97",NA,"Northwest"
"1835","13-1131","Fundraisers","493",528,35,0.071,4,16,32,52,"23.76",NA,"Northwest"
"1836","13-1151","Training and Development Specialists","1038",1123,85,0.0819,8,33,66,107,"22.95",NA,"Northwest"
"1837","13-1161","Market Research Analysts and Marketing Specialists","2119",2466,347,0.1638,35,54,168,257,"28.63",NA,"Northwest"
"1838","13-1198","Project Management Specialists and Business Operations Specialists, All Other","3962",4180,218,0.055,22,94,200,316,"35.9","^^^","Northwest"
"1839","13-2011","Accountants and Auditors","4031",4210,179,0.0444,18,115,244,377,"30.17",NA,"Northwest"
"1840","13-2041","Credit Analysts","166",136,-30,-0.1807,-3,3,10,10,"29.56",NA,"Northwest"
"1841","13-2052","Personal Financial Advisors","389",394,5,0.0129,0,9,19,28,"37.71",NA,"Northwest"
"1842","13-2053","Insurance Underwriters","149",140,-9,-0.0604,-1,3,8,10,"36.94",NA,"Northwest"
"1843","13-2072","Loan Officers","927",801,-126,-0.1359,-13,19,47,53,"29.36",NA,"Northwest"
"1844","13-2082","Tax Preparers","241",240,-1,-0.0041,0,13,13,26,"14.57",NA,"Northwest"
"1845","13-2098","Financial and Investment Analysts, Financial Risk Specialists, and Financial Specialists, All Other","454",481,27,0.0595,3,8,27,38,"35.21","^^^","Northwest"
"1846","15-0000","Computer and Mathematical Occupations","7626",8227,601,0.0788,60,161,393,614,"30.27",NA,"Northwest"
"1847","15-1211","Computer Systems Analysts","791",821,30,0.0379,3,16,40,59,"37.26",NA,"Northwest"
"1848","15-1231","Computer Network Support Specialists","800",790,-10,-0.0125,-1,15,42,56,"22.76",NA,"Northwest"
"1849","15-1232","Computer User Support Specialists","1182",1212,30,0.0254,3,22,63,88,"22.44",NA,"Northwest"
"1850","15-1241","Computer Network Architects","222",233,11,0.0495,1,3,10,14,"47.15",NA,"Northwest"
"1851","15-1244","Network and Computer Systems Administrators","913",922,9,0.0099,1,15,43,59,"36.78",NA,"Northwest"
"1852","15-1245","Database Administrators and Architects","302",327,25,0.0828,2,7,15,24,"47.44","^^^","Northwest"
"1853","15-1251","Computer Programmers","386",350,-36,-0.0933,-4,7,17,20,"36.96",NA,"Northwest"
"1854","15-1256","Software Developers and Software Quality Assurance Analysts and Testers","1816",2197,381,0.2098,38,46,98,182,"49.49","^^^","Northwest"
"1855","15-1257","Web Developers and Digital Interface Designers","268",278,10,0.0373,1,6,13,20,"49.49","^^^","Northwest"
"1856","15-1299","Computer Occupations, All Other","505",537,32,0.0634,3,12,26,41,"36.049999999999997",NA,"Northwest"
"1857","15-2031","Operations Research Analysts","139",169,30,0.2158,3,3,7,13,"38.19",NA,"Northwest"
"1858","17-0000","Architecture and Engineering Occupations","9294",10048,754,0.0811,75,226,461,762,"36.85",NA,"Northwest"
"1859","17-1011","Architects, Except Landscape and Naval","174",175,1,0.0057,0,5,7,12,"37.03",NA,"Northwest"
"1860","17-1022","Surveyors","154",152,-2,-0.013,0,5,8,13,"28.95",NA,"Northwest"
"1861","17-2051","Civil Engineers","734",778,44,0.0599,4,15,38,57,"37.53",NA,"Northwest"
"1862","17-2071","Electrical Engineers","644",703,59,0.0916,6,16,27,49,"44.69",NA,"Northwest"
"1863","17-2081","Environmental Engineers","104",104,0,0,0,2,5,7,"47.62",NA,"Northwest"
"1864","17-2112","Industrial Engineers","1591",1869,278,0.1747,28,38,69,135,"37.909999999999997",NA,"Northwest"
"1865","17-2131","Materials Engineers","225",244,19,0.0844,2,5,9,16,"38.42",NA,"Northwest"
"1866","17-2141","Mechanical Engineers","1594",1781,187,0.1173,19,29,70,118,"36.74",NA,"Northwest"
"1867","17-2199","Engineers, All Other","584",642,58,0.0993,6,13,25,44,"37.39",NA,"Northwest"
"1868","17-3011","Architectural and Civil Drafters","299",287,-12,-0.0401,-1,9,19,27,"27.18",NA,"Northwest"
"1869","17-3013","Mechanical Drafters","168",158,-10,-0.0595,-1,5,10,14,"27.36",NA,"Northwest"
"1870","17-3022","Civil Engineering Technicians","228",227,-1,-0.0044,0,7,14,21,"28.64",NA,"Northwest"
"1871","17-3023","Electrical and Electronics Engineering Technicians","471",505,34,0.0722,3,15,30,48,"29.78",NA,"Northwest"
"1872","17-3026","Industrial Engineering Technicians","367",387,20,0.0545,2,11,23,36,"28.64",NA,"Northwest"
"1873","17-3027","Mechanical Engineering Technicians","264",283,19,0.072,2,8,17,27,"28.3",NA,"Northwest"
"1874","17-3031","Surveying and Mapping Technicians","210",208,-2,-0.0095,0,7,18,25,"18.2",NA,"Northwest"
"1875","19-0000","Life, Physical, and Social Science Occupations","3343",3519,176,0.0526,18,76,236,330,"30.03",NA,"Northwest"
"1876","19-1031","Conservation Scientists","103",106,3,0.0291,0,2,7,9,"26.54",NA,"Northwest"
"1877","19-2031","Chemists","243",262,19,0.0782,2,4,19,25,"30.97",NA,"Northwest"
"1878","19-2041","Environmental Scientists and Specialists, Including Health","240",252,12,0.05,1,4,20,25,"35.69",NA,"Northwest"
"1879","19-3031","Clinical, Counseling, and School Psychologists","332",343,11,0.0331,1,9,13,23,"38.96","^^^","Northwest"
"1880","19-4031","Chemical Technicians","359",377,18,0.0501,2,6,33,41,"23.43",NA,"Northwest"
"1881","19-4042","Environmental Science and Protection Technicians, Including Health","154",159,5,0.0325,0,4,15,19,"21.74",NA,"Northwest"
"1882","19-5011","Occupational Health and Safety Specialists","561",593,32,0.057,3,16,25,44,"37.03",NA,"Northwest"
"1883","19-5012","Occupational Health and Safety Technicians","115",118,3,0.0261,0,3,5,8,"28.31",NA,"Northwest"
"1884","21-0000","Community and Social Service Occupations","10176",10740,564,0.0554,56,361,668,1085,"22.58",NA,"Northwest"
"1885","21-1012","Educational, Guidance, School, and Vocational Counselors","1195",1257,62,0.0519,6,40,73,119,"28.45",NA,"Northwest"
"1886","21-1015","Rehabilitation Counselors","528",600,72,0.1364,7,18,33,58,"17.48",NA,"Northwest"
"1887","21-1018","Substance Abuse, Behavioral Disorder, and Mental Health Counselors","779",916,137,0.1759,14,28,50,92,"22.62",NA,"Northwest"
"1888","21-1021","Child, Family, and School Social Workers","861",913,52,0.0604,5,25,56,86,"22.62",NA,"Northwest"
"1889","21-1022","Healthcare Social Workers","665",682,17,0.0256,2,19,43,64,"24.41",NA,"Northwest"
"1890","21-1023","Mental Health and Substance Abuse Social Workers","835",914,79,0.0946,8,24,55,87,"22.5",NA,"Northwest"
"1891","21-1029","Social Workers, All Other","205",221,16,0.078,2,6,14,22,"22.78",NA,"Northwest"
"1892","21-1091","Health Educators","268",278,10,0.0373,1,9,19,29,"25.08",NA,"Northwest"
"1893","21-1092","Probation Officers and Correctional Treatment Specialists","462",471,9,0.0195,1,10,28,39,"28.54",NA,"Northwest"
"1894","21-1093","Social and Human Service Assistants","1767",1881,114,0.0645,11,73,138,222,"17.239999999999998",NA,"Northwest"
"1895","21-1094","Community Health Workers","180",200,20,0.1111,2,6,13,21,"18.16",NA,"Northwest"
"1896","21-1099","Community and Social Service Specialists, All Other","121",129,8,0.0661,1,4,9,14,"18.64",NA,"Northwest"
"1897","21-2011","Clergy","1822",1796,-26,-0.0143,-3,74,104,175,"21.75",NA,"Northwest"
"1898","23-0000","Legal Occupations","2459",2522,63,0.0256,6,67,94,167,"30.29",NA,"Northwest"
"1899","23-1011","Lawyers","1301",1330,29,0.0223,3,28,32,63,"45.87",NA,"Northwest"
"1900","23-1023","Judges, Magistrate Judges, and Magistrates","333",334,1,0.003,0,7,8,15,"60.41",NA,"Northwest"
"1901","23-2011","Paralegals and Legal Assistants","651",683,32,0.0492,3,26,45,74,"17.73",NA,"Northwest"
"1902","25-0000","Education, Training, and Library Occupations","30823",32540,1717,0.0557,172,1204,1406,2782,"28.36",NA,"Northwest"
"1903","25-1011","Business Teachers, Postsecondary","373",350,-23,-0.0617,-2,16,17,31,"75182","**","Northwest"
"1904","25-1021","Computer Science Teachers, Postsecondary","102",96,-6,-0.0588,-1,4,5,8,"81983","**","Northwest"
"1905","25-1022","Mathematical Science Teachers, Postsecondary","215",201,-14,-0.0651,-1,9,10,18,"63904","**","Northwest"
"1906","25-1032","Engineering Teachers, Postsecondary","267",266,-1,-0.0037,0,12,12,24,"99215","**","Northwest"
"1907","25-1066","Psychology Teachers, Postsecondary","124",119,-5,-0.0403,0,5,6,11,"81983","**","Northwest"
"1908","25-1071","Health Specialties Teachers, Postsecondary","813",889,76,0.0935,8,38,40,86,"82327","**","Northwest"
"1909","25-1072","Nursing Instructors and Teachers, Postsecondary","295",323,28,0.0949,3,14,14,31,"74277","**","Northwest"
"1910","25-1121","Art, Drama, and Music Teachers, Postsecondary","399",385,-14,-0.0351,-1,18,18,35,"63904","**","Northwest"
"1911","25-1122","Communications Teachers, Postsecondary","134",123,-11,-0.0821,-1,6,6,11,"77026","**","Northwest"
"1912","25-1123","English Language and Literature Teachers, Postsecondary","252",241,-11,-0.0437,-1,11,12,22,"63904","**","Northwest"
"1913","25-1194","Vocational Education Teachers, Postsecondary","282",265,-17,-0.0603,-2,12,13,23,"23.97",NA,"Northwest"
"1914","25-1199","Postsecondary Teachers, All Other","200",189,-11,-0.055,-1,9,9,17,"60902","**","Northwest"
"1915","25-2011","Preschool Teachers, Except Special Education","1103",1317,214,0.194,21,50,71,142,"13.77",NA,"Northwest"
"1916","25-2012","Kindergarten Teachers, Except Special Education","309",332,23,0.0744,2,13,19,34,"58928","**","Northwest"
"1917","25-2021","Elementary School Teachers, Except Special Education","5967",6379,412,0.069,41,189,247,477,"61199","**","Northwest"
"1918","25-2022","Middle School Teachers, Except Special and Career/Technical Education","2333",2492,159,0.0682,16,74,97,187,"60941","**","Northwest"
"1919","25-2031","Secondary School Teachers, Except Special and Career/Technical Education","6040",6451,411,0.068,41,166,253,460,"62834","**","Northwest"
"1920","25-2032","Career/Technical Education Teachers, Secondary School","281",299,18,0.0641,2,8,12,22,"75840","**","Northwest"
"1921","25-2052","Special Education Teachers, Kindergarten and Elementary School","701",746,45,0.0642,4,24,29,57,"60533","**","Northwest"
"1922","25-2057","Special Education Teachers, Middle School","235",248,13,0.0553,1,8,10,19,"49380","**","Northwest"
"1923","25-2058","Special Education Teachers, Secondary School","970",1006,36,0.0371,4,32,39,75,"49516","**","Northwest"
"1924","25-3031","Substitute Teachers, Short-Term","988",1109,121,0.1225,12,63,56,131,"13.88",NA,"Northwest"
"1925","25-3097","Teachers and Instructors, All Other, Except Substitute Teachers","755",803,48,0.0636,5,46,42,93,"17.940000000000001","^^^","Northwest"
"1926","25-4022","Librarians and Media Collections Specialists","544",552,8,0.0147,1,27,24,52,"22.84",NA,"Northwest"
"1927","25-4031","Library Technicians","339",315,-24,-0.0708,-2,27,20,45,"13.9",NA,"Northwest"
"1928","25-9031","Instructional Coordinators","464",470,6,0.0129,1,23,20,44,"28.92",NA,"Northwest"
"1929","25-9044","Teaching Assistants, Postsecondary","124",116,-8,-0.0645,-1,5,6,10,"19214","**","Northwest"
"1930","25-9045","Teaching Assistants, Except Postsecondary","3807",3996,189,0.0496,19,174,182,375,"27854","**","Northwest"
"1931","27-0000","Arts, Design, Entertainment, Sports, and Media Occupations","8116",8275,159,0.0196,16,346,539,901,"18.41",NA,"Northwest"
"1932","27-1011","Art Directors","293",302,9,0.0307,1,14,16,31,"38.72",NA,"Northwest"
"1933","27-1021","Commercial and Industrial Designers","110",111,1,0.0091,0,3,7,10,"29.84",NA,"Northwest"
"1934","27-1023","Floral Designers","258",193,-65,-0.2519,-6,7,13,14,"13.69",NA,"Northwest"
"1935","27-1024","Graphic Designers","953",962,9,0.0094,1,29,57,87,"22.62",NA,"Northwest"
"1936","27-1025","Interior Designers","123",118,-5,-0.0407,0,4,7,11,"21.87",NA,"Northwest"
"1937","27-1026","Merchandise Displayers and Window Trimmers","354",363,9,0.0254,1,11,21,33,"13.99",NA,"Northwest"
"1938","27-2012","Producers and Directors","196",205,9,0.0459,1,4,13,18,"23.71",NA,"Northwest"
"1939","27-2022","Coaches and Scouts","2192",2375,183,0.0835,18,130,184,332,"28119","**","Northwest"
"1940","27-2041","Music Directors and Composers","207",206,-1,-0.0048,0,12,12,24,"19.36",NA,"Northwest"
"1941","27-3011","Radio and Television Announcers","135",131,-4,-0.0296,0,5,7,12,"11.15",NA,"Northwest"
"1942","27-3023","News Analysts, Reporters, and Journalists","203",183,-20,-0.0985,-2,6,15,19,"18.399999999999999",NA,"Northwest"
"1943","27-3031","Public Relations Specialists","580",618,38,0.0655,4,15,39,58,"23.67",NA,"Northwest"
"1944","27-3041","Editors","146",134,-12,-0.0822,-1,5,9,13,"23.34",NA,"Northwest"
"1945","27-3043","Writers and Authors","374",341,-33,-0.0882,-3,14,20,31,"21.57",NA,"Northwest"
"1946","27-4012","Broadcast Technicians","119",115,-4,-0.0336,0,3,9,12,"17.989999999999998",NA,"Northwest"
"1947","27-4021","Photographers","321",270,-51,-0.1589,-5,10,17,22,"15.13",NA,"Northwest"
"1948","29-0000","Healthcare Practitioners and Technical Occupations","37908",38969,1061,0.028,106,989,1168,2263,"29.27",NA,"Northwest"
"1949","29-1011","Chiropractors","182",182,0,0,0,3,2,5,"29.38",NA,"Northwest"
"1950","29-1031","Dietitians and Nutritionists","251",260,9,0.0359,1,8,9,18,"28.87",NA,"Northwest"
"1951","29-1041","Optometrists","226",224,-2,-0.0088,0,4,3,7,"49.29",NA,"Northwest"
"1952","29-1051","Pharmacists","1604",1513,-91,-0.0567,-9,29,30,50,"60.92",NA,"Northwest"
"1953","29-1071","Physician Assistants","278",351,73,0.2626,7,5,12,24,"58.21",NA,"Northwest"
"1954","29-1122","Occupational Therapists","610",645,35,0.0574,4,14,20,38,"37.61",NA,"Northwest"
"1955","29-1123","Physical Therapists","799",872,73,0.0914,7,16,17,40,"45.97",NA,"Northwest"
"1956","29-1126","Respiratory Therapists","665",755,90,0.1353,9,15,18,42,"28.52",NA,"Northwest"
"1957","29-1127","Speech-Language Pathologists","677",783,106,0.1566,11,17,26,54,"36.29",NA,"Northwest"
"1958","29-1131","Veterinarians","250",221,-29,-0.116,-3,4,4,5,"46.68",NA,"Northwest"
"1959","29-1141","Registered Nurses","13307",13440,133,0.01,13,357,336,706,"30",NA,"Northwest"
"1960","29-1171","Nurse Practitioners","1011",1539,528,0.5223,53,27,40,120,"49.01",NA,"Northwest"
"1961","29-1215","Family Medicine Physicians","343",341,-2,-0.0058,0,6,4,10,"79.760000000000005",NA,"Northwest"
"1962","29-1216","General Internal Medicine Physicians","162",146,-16,-0.0988,-2,2,2,2,"#",NA,"Northwest"
"1963","29-1228","Physicians, All Other; and Ophthalmologists, Except Pediatric","1392",1400,8,0.0057,1,22,16,39,"37.450000000000003","^^^","Northwest"
"1964","29-1248","Surgeons, Except Ophthalmologists","153",137,-16,-0.1046,-2,2,2,2,"# ^^^",NA,"Northwest"
"1965","29-1292","Dental Hygienists","931",986,55,0.0591,6,34,24,64,"30.2",NA,"Northwest"
"1966","29-2010","Clinical Laboratory Technologists and Technicians","1457",1435,-22,-0.0151,-2,37,54,89,"28.52",NA,"Northwest"
"1967","29-2031","Cardiovascular Technologists and Technicians","277",279,2,0.0072,0,8,12,20,"28.9",NA,"Northwest"
"1968","29-2032","Diagnostic Medical Sonographers","379",410,31,0.0818,3,11,17,31,"30",NA,"Northwest"
"1969","29-2033","Nuclear Medicine Technologists","136",136,0,0,0,4,6,10,"36.08",NA,"Northwest"
"1970","29-2034","Radiologic Technologists","946",933,-13,-0.0137,-1,26,40,65,"28.52",NA,"Northwest"
"1971","29-2035","Magnetic Resonance Imaging Technologists","169",161,-8,-0.0473,-1,4,7,10,"34.97",NA,"Northwest"
"1972","29-2040","Emergency Medical Technicians and Paramedics","839",802,-37,-0.0441,-4,15,38,49,"17.760000000000002","^","Northwest"
"1973","29-2052","Pharmacy Technicians","2050",2061,11,0.0054,1,56,88,145,"14.14",NA,"Northwest"
"1974","29-2055","Surgical Technologists","432",435,3,0.0069,0,12,19,31,"22.45",NA,"Northwest"
"1975","29-2056","Veterinary Technologists and Technicians","264",228,-36,-0.1364,-4,7,11,14,"17.48",NA,"Northwest"
"1976","29-2061","Licensed Practical and Licensed Vocational Nurses","4008",4109,101,0.0252,10,137,169,316,"22.47",NA,"Northwest"
"1977","29-2081","Opticians, Dispensing","320",311,-9,-0.0281,-1,13,11,23,"21.95",NA,"Northwest"
"1978","29-2098","Medical Dosimetrists, Medical Records Specialists, and Health Technologists and Technicians, All Other","1474",1507,33,0.0224,3,41,64,108,"22.55","^^^","Northwest"
"1979","29-9098","Health Information Technologists, Medical Registrars, Surgical Assistants, & Healthcare Practitioners, AO","228",231,3,0.0132,0,6,10,16,"26.19","^^^","Northwest"
"1980","31-0000","Healthcare Support Occupations","23878",26088,2210,0.0926,221,1441,1556,3218,"14.03",NA,"Northwest"
"1981","31-1120","Home Health and Personal Care Aides","9057",10598,1541,0.1701,154,629,556,1339,"11.49",NA,"Northwest"
"1982","31-1131","Nursing Assistants","6813",6738,-75,-0.011,-8,434,384,810,"14.08",NA,"Northwest"
"1983","31-1132","Orderlies","178",183,5,0.0281,0,12,10,22,"14.28",NA,"Northwest"
"1984","31-2011","Occupational Therapy Assistants","404",516,112,0.2772,11,23,34,68,"29.22",NA,"Northwest"
"1985","31-2021","Physical Therapist Assistants","900",1092,192,0.2133,19,43,75,137,"29.28",NA,"Northwest"
"1986","31-9011","Massage Therapists","330",373,43,0.1303,4,21,18,43,"21.83",NA,"Northwest"
"1987","31-9091","Dental Assistants","868",918,50,0.0576,5,41,63,109,"17.97",NA,"Northwest"
"1988","31-9092","Medical Assistants","3400",3777,377,0.1109,38,147,268,453,"16.91",NA,"Northwest"
"1989","31-9093","Medical Equipment Preparers","283",285,2,0.0071,0,16,19,35,"17.48",NA,"Northwest"
"1990","31-9094","Medical Transcriptionists","105",78,-27,-0.2571,-3,5,8,10,"14.26",NA,"Northwest"
"1991","31-9096","Veterinary Assistants and Laboratory Animal Caretakers","306",267,-39,-0.1275,-4,14,32,42,"13.86",NA,"Northwest"
"1992","31-9097","Phlebotomists","860",894,34,0.0395,3,38,64,105,"17.38",NA,"Northwest"
"1993","31-9099","Healthcare Support Workers, All Other","163",161,-2,-0.0123,0,9,11,20,"14.42",NA,"Northwest"
"1994","33-0000","Protective Service Occupations","9980",10011,31,0.0031,3,456,621,1080,"22.75",NA,"Northwest"
"1995","33-1012","First-Line Supervisors of Police and Detectives","254",259,5,0.0197,0,6,10,16,"37.56",NA,"Northwest"
"1996","33-1021","First-Line Supervisors of Fire Fighting and Prevention Workers","261",268,7,0.0268,1,6,11,18,"37.159999999999997",NA,"Northwest"
"1997","33-1090","Miscellaneous First-Line Supervisors, Protective Service Workers","143",137,-6,-0.042,-1,5,8,12,"25.23","^","Northwest"
"1998","33-2011","Firefighters","1459",1508,49,0.0336,5,33,77,115,"22.4",NA,"Northwest"
"1999","33-3011","Bailiffs","155",151,-4,-0.0258,0,6,8,14,"22.58",NA,"Northwest"
"2000","33-3012","Correctional Officers and Jailers","1284",1142,-142,-0.1106,-14,46,66,98,"23.04",NA,"Northwest"
"2001","33-3021","Detectives and Criminal Investigators","255",261,6,0.0235,1,7,12,20,"37.659999999999997",NA,"Northwest"
"2002","33-3051","Police and Sheriff's Patrol Officers","2671",2711,40,0.015,4,67,137,208,"29.17",NA,"Northwest"
"2003","33-9032","Security Guards","2077",2012,-65,-0.0313,-6,108,158,260,"13.9",NA,"Northwest"
"2004","33-9092","Lifeguards, Ski Patrol, and Other Recreational Protective Service Workers","398",482,84,0.2111,8,61,49,118,"10.52",NA,"Northwest"
"2005","33-9098","School Bus Monitors and Protective Service Workers, All Other","503",535,32,0.0636,3,72,58,133,"15.11","^^^","Northwest"
"2006","35-0000","Food Preparation and Serving Related Occupations","47759",52965,5206,0.109,521,3899,5145,9565,"10.76",NA,"Northwest"
"2007","35-1011","Chefs and Head Cooks","188",205,17,0.0904,2,6,19,27,"22.42",NA,"Northwest"
"2008","35-1012","First-Line Supervisors of Food Preparation and Serving Workers","4331",4933,602,0.139,60,207,472,739,"14.67",NA,"Northwest"
"2009","35-2011","Cooks, Fast Food","967",878,-89,-0.092,-9,54,79,124,"10.52",NA,"Northwest"
"2010","35-2012","Cooks, Institution and Cafeteria","2612",2667,55,0.0211,6,155,226,387,"13.99",NA,"Northwest"
"2011","35-2014","Cooks, Restaurant","3525",4899,1374,0.3898,137,248,360,745,"13.63",NA,"Northwest"
"2012","35-2021","Food Preparation Workers","3258",3343,85,0.0261,8,259,304,571,"11.45",NA,"Northwest"
"2013","35-3011","Bartenders","2881",3516,635,0.2204,64,145,388,597,"10.130000000000001",NA,"Northwest"
"2014","35-3023","Fast Food and Counter Workers","18750",20076,1326,0.0707,133,1882,2052,4067,"10.54",NA,"Northwest"
"2015","35-3031","Waiters and Waitresses","6023",6689,666,0.1106,67,467,759,1293,"9.77",NA,"Northwest"
"2016","35-3041","Food Servers, Nonrestaurant","1434",1407,-27,-0.0188,-3,112,111,220,"11.65",NA,"Northwest"
"2017","35-9011","Dining Room and Cafeteria Attendants and Bartender Helpers","1228",1482,254,0.2068,25,117,117,259,"10.91",NA,"Northwest"
"2018","35-9021","Dishwashers","1163",1275,112,0.0963,11,92,102,205,"10.55",NA,"Northwest"
"2019","37-0000","Building and Grounds Cleaning and Maintenance Occupations","17236",17291,55,0.0032,6,991,1259,2256,"13.96",NA,"Northwest"
"2020","37-1011","First-Line Supervisors of Housekeeping and Janitorial Workers","641",622,-19,-0.0296,-2,27,44,69,"18.7",NA,"Northwest"
"2021","37-2011","Janitors and Cleaners, Except Maids and Housekeeping Cleaners","8543",8564,21,0.0025,2,534,600,1136,"13.91",NA,"Northwest"
"2022","37-2012","Maids and Housekeeping Cleaners","3513",3507,-6,-0.0017,-1,238,226,463,"11.49",NA,"Northwest"
"2023","37-3011","Landscaping and Groundskeeping Workers","3936",3997,61,0.0155,6,171,340,517,"14.32",NA,"Northwest"
"2024","37-3012","Pesticide Handlers, Sprayers, and Applicators, Vegetation","152",153,1,0.0066,0,7,13,20,"18.760000000000002",NA,"Northwest"
"2025","39-0000","Personal Care and Service Occupations","10638",11424,786,0.0739,79,695,863,1637,"11.27",NA,"Northwest"
"2026","39-2021","Nonfarm Animal Caretakers","879",1104,225,0.256,22,64,82,168,"10.94",NA,"Northwest"
"2027","39-3031","Ushers, Lobby Attendants, and Ticket Takers","178",246,68,0.382,7,27,22,56,"10.53",NA,"Northwest"
"2028","39-3091","Amusement and Recreation Attendants","914",1053,139,0.1521,14,96,110,220,"10.07",NA,"Northwest"
"2029","39-4021","Funeral Attendants","349",347,-2,-0.0057,0,20,26,46,"13.93",NA,"Northwest"
"2030","39-5012","Hairdressers, Hairstylists, and Cosmetologists","1819",1769,-50,-0.0275,-5,95,100,190,"11.25",NA,"Northwest"
"2031","39-5094","Skincare Specialists","143",151,8,0.0559,1,8,8,17,"17.48",NA,"Northwest"
"2032","39-7010","Tour and Travel Guides","102",126,24,0.2353,2,7,11,20,"11.49",NA,"Northwest"
"2033","39-9011","Childcare Workers","2677",2677,0,0,0,180,187,367,"10.66",NA,"Northwest"
"2034","39-9031","Fitness Trainers and Aerobics Instructors","945",1161,216,0.2286,22,62,100,184,"13.97",NA,"Northwest"
"2035","39-9032","Recreation Workers","863",888,25,0.029,2,51,83,136,"13.3",NA,"Northwest"
"2036","41-0000","Sales and Related Occupations","46339",44278,-2061,-0.0445,-206,2377,3603,5774,"13.79",NA,"Northwest"
"2037","41-1011","First-Line Supervisors of Retail Sales Workers","4832",4483,-349,-0.0722,-35,165,323,453,"18.100000000000001",NA,"Northwest"
"2038","41-1012","First-Line Supervisors of Non-Retail Sales Workers","838",752,-86,-0.1026,-9,23,47,61,"35.869999999999997",NA,"Northwest"
"2039","41-2011","Cashiers","11906",10449,-1457,-0.1224,-146,951,1070,1875,"10.84",NA,"Northwest"
"2040","41-2022","Parts Salespersons","1228",1283,55,0.0448,6,53,96,155,"14.41",NA,"Northwest"
"2041","41-2031","Retail Salespersons","12479",12228,-251,-0.0201,-25,691,1020,1686,"13.22",NA,"Northwest"
"2042","41-3011","Advertising Sales Agents","328",313,-15,-0.0457,-2,10,30,38,"18.46",NA,"Northwest"
"2043","41-3021","Insurance Sales Agents","1972",2022,50,0.0254,5,66,112,183,"23.11",NA,"Northwest"
"2044","41-3031","Securities, Commodities, and Financial Services Sales Agents","1571",1377,-194,-0.1235,-19,33,93,107,"27.45",NA,"Northwest"
"2045","41-3091","Sales Representatives of Services, Except Advertising, Insurance, Financial Services, and Travel","1884",2049,165,0.0876,16,49,173,238,"23.75",NA,"Northwest"
"2046","41-4011","Sales Representatives, Wholesale and Manufacturing, Technical and Scientific Products","411",427,16,0.0389,2,12,28,42,"45.7",NA,"Northwest"
"2047","41-4012","Sales Representatives, Wholesale and Manufacturing, Except Technical and Scientific Products","5416",5544,128,0.0236,13,162,370,545,"28.63",NA,"Northwest"
"2048","41-9011","Demonstrators and Product Promoters","107",113,6,0.0561,1,12,7,20,"14.58","†","Northwest"
"2049","41-9022","Real Estate Sales Agents","617",633,16,0.0259,2,26,28,56,"18.079999999999998",NA,"Northwest"
"2050","43-0000","Office and Administrative Support Occupations","64641",59966,-4675,-0.0723,-468,2974,3782,6288,"17.739999999999998",NA,"Northwest"
"2051","43-1011","First-Line Supervisors of Office and Administrative Support Workers","4261",3926,-335,-0.0786,-34,152,250,368,"27.42",NA,"Northwest"
"2052","43-3011","Bill and Account Collectors","970",879,-91,-0.0938,-9,34,66,91,"17.45",NA,"Northwest"
"2053","43-3021","Billing and Posting Clerks","1893",1897,4,0.0021,0,78,116,194,"17.75",NA,"Northwest"
"2054","43-3031","Bookkeeping, Accounting, and Auditing Clerks","6004",5677,-327,-0.0545,-33,342,298,607,"18.27",NA,"Northwest"
"2055","43-3051","Payroll and Timekeeping Clerks","336",286,-50,-0.1488,-5,15,17,27,"21.92",NA,"Northwest"
"2056","43-3061","Procurement Clerks","272",258,-14,-0.0515,-1,7,17,23,"18.27",NA,"Northwest"
"2057","43-3071","Tellers","2288",1533,-755,-0.33,-76,78,120,122,"14.26",NA,"Northwest"
"2058","43-4031","Court, Municipal, and License Clerks","1116",1165,49,0.0439,5,56,57,118,"17.760000000000002",NA,"Northwest"
"2059","43-4051","Customer Service Representatives","6973",6507,-466,-0.0668,-47,317,530,800,"17.399999999999999",NA,"Northwest"
"2060","43-4061","Eligibility Interviewers, Government Programs","341",347,6,0.0176,1,13,18,32,"18.12",NA,"Northwest"
"2061","43-4071","File Clerks","272",228,-44,-0.1618,-4,14,15,25,"17.579999999999998",NA,"Northwest"
"2062","43-4081","Hotel, Motel, and Resort Desk Clerks","444",507,63,0.1419,6,28,50,84,"11",NA,"Northwest"
"2063","43-4111","Interviewers, Except Eligibility and Loan","853",658,-195,-0.2286,-20,44,49,73,"17.28",NA,"Northwest"
"2064","43-4121","Library Assistants, Clerical","513",475,-38,-0.0741,-4,44,32,72,"11.52",NA,"Northwest"
"2065","43-4131","Loan Interviewers and Clerks","592",500,-92,-0.1554,-9,16,32,39,"17.989999999999998",NA,"Northwest"
"2066","43-4151","Order Clerks","510",414,-96,-0.1882,-10,20,29,39,"17.739999999999998",NA,"Northwest"
"2067","43-4161","Human Resources Assistants, Except Payroll and Timekeeping","376",351,-25,-0.0665,-2,14,22,34,"18.3",NA,"Northwest"
"2068","43-4171","Receptionists and Information Clerks","2888",2806,-82,-0.0284,-8,159,197,348,"13.82",NA,"Northwest"
"2069","43-4199","Information and Record Clerks, All Other","173",175,2,0.0116,0,7,12,19,"17.28",NA,"Northwest"
"2070","43-5011","Cargo and Freight Agents","123",125,2,0.0163,0,5,7,12,"20.55",NA,"Northwest"
"2071","43-5021","Couriers and Messengers","755",629,-126,-0.1669,-13,28,38,53,"13.99",NA,"Northwest"
"2072","43-5031","Police, Fire, and Ambulance Dispatchers","487",492,5,0.0103,0,17,27,44,"22.58",NA,"Northwest"
"2073","43-5032","Dispatchers, Except Police, Fire, and Ambulance","713",697,-16,-0.0224,-2,25,40,63,"18.36",NA,"Northwest"
"2074","43-5051","Postal Service Clerks","316",287,-29,-0.0918,-3,14,11,22,"24.64",NA,"Northwest"
"2075","43-5052","Postal Service Mail Carriers","1441",1308,-133,-0.0923,-13,48,49,84,"25.21",NA,"Northwest"
"2076","43-5061","Production, Planning, and Expediting Clerks","2227",2329,102,0.0458,10,81,148,239,"23.45",NA,"Northwest"
"2077","43-5071","Shipping, Receiving, and Traffic Clerks","3455",3247,-208,-0.0602,-21,122,197,298,"17.600000000000001",NA,"Northwest"
"2078","43-5111","Weighers, Measurers, Checkers, and Samplers, Recordkeeping","191",202,11,0.0576,1,7,11,19,"17.079999999999998",NA,"Northwest"
"2079","43-6011","Executive Secretaries and Executive Administrative Assistants","933",732,-201,-0.2154,-20,42,46,68,"28.17",NA,"Northwest"
"2080","43-6012","Legal Secretaries","556",405,-151,-0.2716,-15,24,27,36,"18.2",NA,"Northwest"
"2081","43-6013","Medical Secretaries","3686",3747,61,0.0165,6,189,208,403,"16.82",NA,"Northwest"
"2082","43-6014","Secretaries and Administrative Assistants, Except Legal, Medical, and Executive","5535",4871,-664,-0.12,-66,265,290,489,"17.579999999999998",NA,"Northwest"
"2083","43-9021","Data Entry Keyers","354",264,-90,-0.2542,-9,14,20,25,"14.48",NA,"Northwest"
"2084","43-9041","Insurance Claims and Policy Processing Clerks","367",352,-15,-0.0409,-2,13,21,32,"18.55",NA,"Northwest"
"2085","43-9051","Mail Clerks and Mail Machine Operators, Except Postal Service","141",135,-6,-0.0426,-1,7,9,15,"13.37",NA,"Northwest"
"2086","43-9061","Office Clerks, General","11115",10529,-586,-0.0527,-59,591,642,1174,"17.57",NA,"Northwest"
"2087","43-9199","Office and Administrative Support Workers, All Other","214",218,4,0.0187,0,9,15,24,"17.62",NA,"Northwest"
"2088","45-0000","Farming, Fishing, and Forestry Occupations","2529",2623,94,0.0372,9,108,292,409,"16.93",NA,"Northwest"
"2089","45-1011","First-Line Supervisors of Farming, Fishing, and Forestry Workers","133",141,8,0.0602,1,5,14,20,"28.41",NA,"Northwest"
"2090","45-2091","Agricultural Equipment Operators","303",330,27,0.0891,3,13,36,52,"21.91",NA,"Northwest"
"2091","47-0000","Construction and Extraction Occupations","23040",23990,950,0.0412,95,693,1611,2399,"23.4",NA,"Northwest"
"2092","47-1011","First-Line Supervisors of Construction Trades and Extraction Workers","1642",1718,76,0.0463,8,48,109,165,"29.98",NA,"Northwest"
"2093","47-2021","Brickmasons and Blockmasons","369",350,-19,-0.0515,-2,11,22,31,"28.89",NA,"Northwest"
"2094","47-2031","Carpenters","2613",2613,0,0,0,76,163,239,"23.55",NA,"Northwest"
"2095","47-2041","Carpet Installers","209",198,-11,-0.0526,-1,5,12,16,"22.4",NA,"Northwest"
"2096","47-2051","Cement Masons and Concrete Finishers","579",561,-18,-0.0311,-2,14,38,50,"23.8",NA,"Northwest"
"2097","47-2061","Construction Laborers","4315",4613,298,0.0691,30,132,302,464,"22.02",NA,"Northwest"
"2098","47-2071","Paving, Surfacing, and Tamping Equipment Operators","245",250,5,0.0204,0,8,18,26,"23.09",NA,"Northwest"
"2099","47-2073","Operating Engineers and Other Construction Equipment Operators","1680",1715,35,0.0208,4,56,122,182,"27.02",NA,"Northwest"
"2100","47-2081","Drywall and Ceiling Tile Installers","111",115,4,0.036,0,3,6,9,"23.8",NA,"Northwest"
"2101","47-2111","Electricians","3649",3966,317,0.0869,32,110,280,422,"29.5",NA,"Northwest"
"2102","47-2121","Glaziers","158",168,10,0.0633,1,4,13,18,"22.47",NA,"Northwest"
"2103","47-2132","Insulation Workers, Mechanical","128",135,7,0.0547,1,3,9,13,"28.55",NA,"Northwest"
"2104","47-2141","Painters, Construction and Maintenance","1059",1102,43,0.0406,4,33,60,97,"22.03",NA,"Northwest"
"2105","47-2151","Pipelayers","220",216,-4,-0.0182,0,6,16,22,"22.26",NA,"Northwest"
"2106","47-2152","Plumbers, Pipefitters, and Steamfitters","1323",1367,44,0.0333,4,39,97,140,"29.63",NA,"Northwest"
"2107","47-2181","Roofers","580",613,33,0.0569,3,15,42,60,"22.09",NA,"Northwest"
"2108","47-2211","Sheet Metal Workers","355",380,25,0.0704,2,10,24,36,"23.09",NA,"Northwest"
"2109","47-2221","Structural Iron and Steel Workers","726",773,47,0.0647,5,19,57,81,"29.09",NA,"Northwest"
"2110","47-4011","Construction and Building Inspectors","174",159,-15,-0.0862,-2,9,10,17,"29.17",NA,"Northwest"
"2111","47-4031","Fence Erectors","123",117,-6,-0.0488,-1,3,9,11,"17.64",NA,"Northwest"
"2112","47-4041","Hazardous Materials Removal Workers","192",198,6,0.0312,1,7,16,24,"22.08",NA,"Northwest"
"2113","47-4051","Highway Maintenance Workers","799",810,11,0.0138,1,32,50,83,"18.36",NA,"Northwest"
"2114","47-4071","Septic Tank Servicers and Sewer Pipe Cleaners","156",166,10,0.0641,1,5,13,19,"22.58",NA,"Northwest"
"2115","49-0000","Installation, Maintenance, and Repair Occupations","26189",27904,1715,0.0655,172,856,1691,2719,"22.81",NA,"Northwest"
"2116","49-1011","First-Line Supervisors of Mechanics, Installers, and Repairers","1934",2030,96,0.0496,10,58,118,186,"35.1",NA,"Northwest"
"2117","49-2011","Computer, Automated Teller, and Office Machine Repairers","220",204,-16,-0.0727,-2,6,16,20,"18.21",NA,"Northwest"
"2118","49-2022","Telecommunications Equipment Installers and Repairers, Except Line Installers","516",537,21,0.0407,2,18,40,60,"29.2",NA,"Northwest"
"2119","49-2094","Electrical and Electronics Repairers, Commercial and Industrial Equipment","145",163,18,0.1241,2,4,8,14,"31.77",NA,"Northwest"
"2120","49-2098","Security and Fire Alarm Systems Installers","214",210,-4,-0.0187,0,5,16,21,"22.65",NA,"Northwest"
"2121","49-3011","Aircraft Mechanics and Service Technicians","171",181,10,0.0585,1,5,9,15,"28.2",NA,"Northwest"
"2122","49-3021","Automotive Body and Related Repairers","1032",1065,33,0.032,3,33,62,98,"22.42",NA,"Northwest"
"2123","49-3023","Automotive Service Technicians and Mechanics","3221",3208,-13,-0.004,-1,96,218,313,"18.18",NA,"Northwest"
"2124","49-3031","Bus and Truck Mechanics and Diesel Engine Specialists","1056",1096,40,0.0379,4,30,67,101,"22.58",NA,"Northwest"
"2125","49-3041","Farm Equipment Mechanics and Service Technicians","217",234,17,0.0783,2,7,15,24,"18.100000000000001",NA,"Northwest"
"2126","49-3042","Mobile Heavy Equipment Mechanics, Except Engines","498",543,45,0.0904,4,16,35,55,"25",NA,"Northwest"
"2127","49-3093","Tire Repairers and Changers","259",264,5,0.0193,0,8,22,30,"14.29",NA,"Northwest"
"2128","49-9011","Mechanical Door Repairers","105",115,10,0.0952,1,2,6,9,"21.63",NA,"Northwest"
"2129","49-9012","Control and Valve Installers and Repairers, Except Mechanical Door","141",137,-4,-0.0284,0,3,8,11,"29.42",NA,"Northwest"
"2130","49-9021","Heating, Air Conditioning, and Refrigeration Mechanics and Installers","1217",1258,41,0.0337,4,32,84,120,"22.93",NA,"Northwest"
"2131","49-9041","Industrial Machinery Mechanics","2610",3345,735,0.2816,74,92,161,327,"28.9",NA,"Northwest"
"2132","49-9043","Maintenance Workers, Machinery","371",430,59,0.159,6,13,22,41,"28.55",NA,"Northwest"
"2133","49-9044","Millwrights","681",783,102,0.1498,10,21,42,73,"37.22",NA,"Northwest"
"2134","49-9051","Electrical Power-Line Installers and Repairers","464",490,26,0.056,3,9,32,44,"37.42",NA,"Northwest"
"2135","49-9071","Maintenance and Repair Workers, General","6935",7208,273,0.0394,27,249,413,689,"22.4",NA,"Northwest"
"2136","49-9091","Coin, Vending, and Amusement Machine Servicers and Repairers","165",170,5,0.0303,0,7,12,19,"17.71",NA,"Northwest"
"2137","49-9098","Helpers--Installation, Maintenance, and Repair Workers","192",200,8,0.0417,1,8,16,25,"17.41",NA,"Northwest"
"2138","49-9099","Installation, Maintenance, and Repair Workers, All Other","1476",1701,225,0.1524,22,56,106,184,"17.96",NA,"Northwest"
"2139","51-0000","Production Occupations","76175",75878,-297,-0.0039,-30,2751,5392,8113,"18.13",NA,"Northwest"
"2140","51-1011","First-Line Supervisors of Production and Operating Workers","4402",4570,168,0.0382,17,135,302,454,"29.35",NA,"Northwest"
"2141","51-2028","Electrical, Electronic, and Electromechanical Assemblers, Except Coil Winders, Tapers, and Finishers","1202",1356,154,0.1281,15,51,82,148,"17.48",NA,"Northwest"
"2142","51-2041","Structural Metal Fabricators and Fitters","359",322,-37,-0.1031,-4,8,27,31,"21.18",NA,"Northwest"
"2143","51-2090","Miscellaneous Assemblers and Fabricators","19576",19482,-94,-0.0048,-9,745,1394,2130,"18.13",NA,"Northwest"
"2144","51-3011","Bakers","505",524,19,0.0376,2,29,38,69,"14.14",NA,"Northwest"
"2145","51-3021","Butchers and Meat Cutters","270",242,-28,-0.1037,-3,10,19,26,"14.16",NA,"Northwest"
"2146","51-3092","Food Batchmakers","1790",1768,-22,-0.0123,-2,83,133,214,"22.1",NA,"Northwest"
"2147","51-4021","Extruding and Drawing Machine Setters, Operators, and Tenders, Metal and Plastic","783",726,-57,-0.0728,-6,26,47,67,"18.05",NA,"Northwest"
"2148","51-4031","Cutting, Punching, and Press Machine Setters, Operators, and Tenders, Metal and Plastic","2665",2608,-57,-0.0214,-6,84,181,259,"18.09",NA,"Northwest"
"2149","51-4033","Grinding, Lapping, Polishing, and Buffing Machine Tool Setters, Operators, and Tenders, Metal and Plastic","622",586,-36,-0.0579,-4,27,42,65,"17.48",NA,"Northwest"
"2150","51-4041","Machinists","3027",3253,226,0.0747,23,105,214,342,"19.28",NA,"Northwest"
"2151","51-4071","Foundry Mold and Coremakers","861",836,-25,-0.029,-2,28,57,83,"18.03",NA,"Northwest"
"2152","51-4072","Molding, Coremaking, and Casting Machine Setters, Operators, and Tenders, Metal and Plastic","2781",2573,-208,-0.0748,-21,87,181,247,"17.45",NA,"Northwest"
"2153","51-4081","Multiple Machine Tool Setters, Operators, and Tenders, Metal and Plastic","2910",3289,379,0.1302,38,101,210,349,"22.59",NA,"Northwest"
"2154","51-4111","Tool and Die Makers","1143",1159,16,0.014,2,42,72,116,"27.27",NA,"Northwest"
"2155","51-4121","Welders, Cutters, Solderers, and Brazers","3078",3308,230,0.0747,23,84,252,359,"18.600000000000001",NA,"Northwest"
"2156","51-4122","Welding, Soldering, and Brazing Machine Setters, Operators, and Tenders","182",182,0,0,0,5,14,19,"17.920000000000002",NA,"Northwest"
"2157","51-4191","Heat Treating Equipment Setters, Operators, and Tenders, Metal and Plastic","135",130,-5,-0.037,0,4,9,13,"18.350000000000001",NA,"Northwest"
"2158","51-4193","Plating and Coating Machine Setters, Operators, and Tenders, Metal and Plastic","450",401,-49,-0.1089,-5,14,29,38,"17.899999999999999",NA,"Northwest"
"2159","51-5111","Prepress Technicians and Workers","101",83,-18,-0.1782,-2,4,9,11,"18.09",NA,"Northwest"
"2160","51-5112","Printing Press Operators","635",573,-62,-0.0976,-6,22,42,58,"17.78",NA,"Northwest"
"2161","51-5113","Print Binding and Finishing Workers","150",110,-40,-0.2667,-4,6,8,10,"14.56",NA,"Northwest"
"2162","51-6011","Laundry and Dry-Cleaning Workers","840",913,73,0.0869,7,57,59,123,"11.29",NA,"Northwest"
"2163","51-6031","Sewing Machine Operators","322",311,-11,-0.0342,-1,19,17,35,"14.14",NA,"Northwest"
"2164","51-7041","Sawing Machine Setters, Operators, and Tenders, Wood","103",112,9,0.0874,1,4,8,13,"14.43",NA,"Northwest"
"2165","51-7042","Woodworking Machine Setters, Operators, and Tenders, Except Sawing","337",366,29,0.0861,3,10,25,38,"17.420000000000002",NA,"Northwest"
"2166","51-8031","Water and Wastewater Treatment Plant and System Operators","602",560,-42,-0.0698,-4,16,36,48,"22.99",NA,"Northwest"
"2167","51-9011","Chemical Equipment Operators and Tenders","400",369,-31,-0.0775,-3,8,30,35,"23.13",NA,"Northwest"
"2168","51-9023","Mixing and Blending Machine Setters, Operators, and Tenders","958",969,11,0.0115,1,32,72,105,"18.09",NA,"Northwest"
"2169","51-9032","Cutting and Slicing Machine Setters, Operators, and Tenders","285",280,-5,-0.0175,0,13,21,34,"18.09",NA,"Northwest"
"2170","51-9041","Extruding, Forming, Pressing, and Compacting Machine Setters, Operators, and Tenders","1065",1029,-36,-0.0338,-4,29,77,102,"17.79",NA,"Northwest"
"2171","51-9051","Furnace, Kiln, Oven, Drier, and Kettle Operators and Tenders","323",330,7,0.0217,1,11,20,32,"22.95",NA,"Northwest"
"2172","51-9061","Inspectors, Testers, Sorters, Samplers, and Weighers","4736",4111,-625,-0.132,-62,170,351,459,"18.27",NA,"Northwest"
"2173","51-9111","Packaging and Filling Machine Operators and Tenders","2360",2413,53,0.0225,5,98,158,261,"18.13",NA,"Northwest"
"2174","51-9124","Coating, Painting, and Spraying Machine Setters, Operators, and Tenders","979",1009,30,0.0306,3,28,71,102,"18.09",NA,"Northwest"
"2175","51-9161","Computer Numerically Controlled Tool Operators","1918",1884,-34,-0.0177,-3,65,140,202,"18.45",NA,"Northwest"
"2176","51-9162","Computer Numerically Controlled Tool Programmers","158",200,42,0.2658,4,6,13,23,"23.98",NA,"Northwest"
"2177","51-9192","Cleaning, Washing, and Metal Pickling Equipment Operators and Tenders","131",142,11,0.084,1,5,10,16,"14.76",NA,"Northwest"
"2178","51-9195","Molders, Shapers, and Casters, Except Metal and Plastic","1133",1135,2,0.0018,0,41,74,115,"18.45",NA,"Northwest"
"2179","51-9196","Paper Goods Machine Setters, Operators, and Tenders","833",885,52,0.0624,5,39,57,101,"18.29",NA,"Northwest"
"2180","51-9198","Helpers--Production Workers","1126",1019,-107,-0.095,-11,50,101,140,"17.850000000000001",NA,"Northwest"
"2181","51-9199","Production Workers, All Other","1479",1518,39,0.0264,4,51,111,166,"14.37",NA,"Northwest"
"2182","53-0000","Transportation and Material Moving Occupations","58628",61869,3241,0.0553,324,2722,4801,7847,"17.59",NA,"Northwest"
"2183","53-3031","Driver/Sales Workers","3021",3394,373,0.1235,37,131,218,386,"11.07",NA,"Northwest"
"2184","53-3032","Heavy and Tractor-Trailer Truck Drivers","10563",10522,-41,-0.0039,-4,432,715,1143,"23.12",NA,"Northwest"
"2185","53-3033","Light Truck or Delivery Services Drivers","3722",4020,298,0.0801,30,158,262,450,"18.190000000000001",NA,"Northwest"
"2186","53-3052","Bus Drivers, Transit and Intercity","117",156,39,0.3333,4,9,7,20,"18.23",NA,"Northwest"
"2187","53-3058","Passenger Vehicle Drivers, Except Bus Drivers, Transit and Intercity","1807",2198,391,0.2164,39,132,100,271,"18.05","^^^","Northwest"
"2188","53-6021","Parking Lot Attendants","406",447,41,0.101,4,21,44,69,"11.62",NA,"Northwest"
"2189","53-6031","Automotive and Watercraft Service Attendants","590",571,-19,-0.0322,-2,27,52,77,"13.63",NA,"Northwest"
"2190","53-7011","Conveyor Operators and Tenders","252",264,12,0.0476,1,8,22,31,"23.63",NA,"Northwest"
"2191","53-7021","Crane and Tower Operators","155",161,6,0.0387,1,4,12,17,"22.62",NA,"Northwest"
"2192","53-7051","Industrial Truck and Tractor Operators","5506",5849,343,0.0623,34,171,436,641,"18.309999999999999",NA,"Northwest"
"2193","53-7061","Cleaners of Vehicles and Equipment","1991",2071,80,0.0402,8,99,181,288,"13.81",NA,"Northwest"
"2194","53-7062","Laborers and Freight, Stock, and Material Movers, Hand","12040",13071,1031,0.0856,103,549,1092,1744,"14.82",NA,"Northwest"
"2195","53-7063","Machine Feeders and Offbearers","127",137,10,0.0787,1,8,10,19,"17.48",NA,"Northwest"
"2196","53-7064","Packers and Packagers, Hand","3595",3729,134,0.0373,13,209,296,518,"14.42",NA,"Northwest"
"2197","53-7065","Stockers and Order Fillers","10466",10798,332,0.0317,33,605,1037,1675,"14.42",NA,"Northwest"
"2198","53-7081","Refuse and Recyclable Material Collectors","464",532,68,0.1466,7,21,45,73,"18.010000000000002",NA,"Northwest"
"2199","53-7121","Tank Car, Truck, and Ship Loaders","324",328,4,0.0123,0,10,28,38,"18.77",NA,"Northwest"
"2200","00-0000","Total, All Occupations","888939",942233,53294,0.06,5329,38372,59776,103477,"22.25",NA,"Southwest"
"2201","11-0000","Management Occupations","51343",55595,4252,0.0828,425,1390,2846,4661,"49.28",NA,"Southwest"
"2202","11-1011","Chief Executives","1163",1070,-93,-0.08,-9,30,45,66,"#",NA,"Southwest"
"2203","11-1021","General and Operations Managers","10919",11695,776,0.0711,78,226,701,1005,"47.59",NA,"Southwest"
"2204","11-1031","Legislators","261",265,4,0.0153,0,6,13,19,"36915","**","Southwest"
"2205","11-2021","Marketing Managers","1629",1722,93,0.0571,9,34,106,149,"63.68",NA,"Southwest"
"2206","11-2022","Sales Managers","2181",2312,131,0.0601,13,45,142,200,"64.040000000000006",NA,"Southwest"
"2207","11-2030","Public Relations and Fundraising Managers","363",392,29,0.0799,3,10,21,34,"57.62","^","Southwest"
"2208","11-3010","Administrative Services and Facilities Managers","1964",2097,133,0.0677,13,58,101,172,"47.73","^","Southwest"
"2209","11-3021","Computer and Information Systems Managers","2870",3062,192,0.0669,19,48,169,236,"63.68",NA,"Southwest"
"2210","11-3031","Financial Managers","5277",6084,807,0.1529,81,116,285,482,"61.55",NA,"Southwest"
"2211","11-3051","Industrial Production Managers","2063",2118,55,0.0267,6,40,99,145,"57.4",NA,"Southwest"
"2212","11-3061","Purchasing Managers","500",524,24,0.048,2,11,28,41,"61.66",NA,"Southwest"
"2213","11-3071","Transportation, Storage, and Distribution Managers","908",1012,104,0.1145,10,18,53,81,"47.08",NA,"Southwest"
"2214","11-3111","Compensation and Benefits Managers","112",112,0,0,0,2,6,8,"62.12",NA,"Southwest"
"2215","11-3121","Human Resources Managers","819",869,50,0.0611,5,20,47,72,"61.17",NA,"Southwest"
"2216","11-3131","Training and Development Managers","203",218,15,0.0739,2,5,14,21,"57.54",NA,"Southwest"
"2217","11-9013","Farmers, Ranchers, and Other Agricultural Managers","4784",4997,213,0.0445,21,302,170,493,"35.119999999999997","^","Southwest"
"2218","11-9021","Construction Managers","1877",2094,217,0.1156,22,41,100,163,"47.78",NA,"Southwest"
"2219","11-9031","Education Administrators, Preschool and Childcare Center/Program","326",364,38,0.1166,4,8,16,28,"22.39",NA,"Southwest"
"2220","11-9032","Education Administrators, Elementary and Secondary School","1153",1272,119,0.1032,12,30,56,98,"97597","**","Southwest"
"2221","11-9033","Education Administrators, Postsecondary","336",335,-1,-0.003,0,8,16,24,"49.35",NA,"Southwest"
"2222","11-9039","Education Administrators, All Other","111",127,16,0.1441,2,3,6,11,"29.67",NA,"Southwest"
"2223","11-9041","Architectural and Engineering Managers","1268",1288,20,0.0158,2,23,65,90,"64.78",NA,"Southwest"
"2224","11-9051","Food Service Managers","1788",2058,270,0.151,27,59,154,240,"28.78",NA,"Southwest"
"2225","11-9081","Lodging Managers","134",143,9,0.0672,1,5,10,16,"24.41",NA,"Southwest"
"2226","11-9111","Medical and Health Services Managers","2368",3068,700,0.2956,70,68,138,276,"49.03",NA,"Southwest"
"2227","11-9121","Natural Sciences Managers","272",287,15,0.0551,2,6,14,22,"61.3",NA,"Southwest"
"2228","11-9141","Property, Real Estate, and Community Association Managers","1719",1774,55,0.032,6,66,66,138,"28.42",NA,"Southwest"
"2229","11-9151","Social and Community Service Managers","843",925,82,0.0973,8,26,47,81,"31.33",NA,"Southwest"
"2230","11-9198","Personal Service Managers; Entertainment & Recreation Managers, Except Gambling; and Managers, All Other","2933",3108,175,0.0597,18,70,148,236,"59.93","^^^","Southwest"
"2231","13-0000","Business and Financial Operations Occupations","64534",68549,4015,0.0622,402,1736,3904,6042,"30.91",NA,"Southwest"
"2232","13-1020","Buyers and Purchasing Agents","2996",2833,-163,-0.0544,-16,99,187,270,"30.66",NA,"Southwest"
"2233","13-1031","Claims Adjusters, Examiners, and Investigators","3145",3004,-141,-0.0448,-14,72,160,218,"29.6",NA,"Southwest"
"2234","13-1041","Compliance Officers","1576",1654,78,0.0495,8,39,86,133,"35.54",NA,"Southwest"
"2235","13-1051","Cost Estimators","1526",1526,0,0,0,43,92,135,"32.200000000000003",NA,"Southwest"
"2236","13-1071","Human Resources Specialists","5629",6212,583,0.1036,58,160,394,612,"29.11",NA,"Southwest"
"2237","13-1075","Labor Relations Specialists","509",451,-58,-0.1139,-6,13,32,39,"39.14",NA,"Southwest"
"2238","13-1081","Logisticians","899",1169,270,0.3003,27,22,67,116,"37.6",NA,"Southwest"
"2239","13-1111","Management Analysts","6288",6857,569,0.0905,57,211,378,646,"38.020000000000003",NA,"Southwest"
"2240","13-1121","Meeting, Convention, and Event Planners","792",876,84,0.1061,8,25,61,94,"23.27",NA,"Southwest"
"2241","13-1131","Fundraisers","1035",1116,81,0.0783,8,33,68,109,"29.29",NA,"Southwest"
"2242","13-1141","Compensation, Benefits, and Job Analysis Specialists","597",646,49,0.0821,5,19,36,60,"29.36",NA,"Southwest"
"2243","13-1151","Training and Development Specialists","2636",2928,292,0.1108,29,84,170,283,"22.69",NA,"Southwest"
"2244","13-1161","Market Research Analysts and Marketing Specialists","5829",6977,1148,0.1969,115,152,468,735,"30.23",NA,"Southwest"
"2245","13-1198","Project Management Specialists and Business Operations Specialists, All Other","9420",9725,305,0.0324,30,222,469,721,"35.9","^^^","Southwest"
"2246","13-2011","Accountants and Auditors","8842",9293,451,0.051,45,253,537,835,"36.03",NA,"Southwest"
"2247","13-2020","Property Appraisers and Assessors","141",140,-1,-0.0071,0,5,5,10,"30.91",NA,"Southwest"
"2248","13-2031","Budget Analysts","203",216,13,0.064,1,5,11,17,"36.76",NA,"Southwest"
"2249","13-2041","Credit Analysts","510",489,-21,-0.0412,-2,8,34,40,"30.57",NA,"Southwest"
"2250","13-2052","Personal Financial Advisors","2077",2270,193,0.0929,19,49,107,175,"41.27",NA,"Southwest"
"2251","13-2053","Insurance Underwriters","1883",1776,-107,-0.0568,-11,37,95,121,"36.76",NA,"Southwest"
"2252","13-2061","Financial Examiners","809",984,175,0.2163,18,24,42,84,"34.94",NA,"Southwest"
"2253","13-2072","Loan Officers","2700",2755,55,0.0204,6,59,148,213,"29.6",NA,"Southwest"
"2254","13-2081","Tax Examiners and Collectors, and Revenue Agents","287",261,-26,-0.0906,-3,11,12,20,"42.6",NA,"Southwest"
"2255","13-2082","Tax Preparers","375",385,10,0.0267,1,21,21,43,"15.45",NA,"Southwest"
"2256","13-2098","Financial and Investment Analysts, Financial Risk Specialists, and Financial Specialists, All Other","3580",3748,168,0.0469,17,64,209,290,"35.21","^^^","Southwest"
"2257","15-0000","Computer and Mathematical Occupations","35368",38983,3615,0.1022,362,765,1831,2958,"38.53",NA,"Southwest"
"2258","15-1211","Computer Systems Analysts","4376",4428,52,0.0119,5,86,217,308,"47.62",NA,"Southwest"
"2259","15-1212","Information Security Analysts","1062",1343,281,0.2646,28,18,66,112,"47.62",NA,"Southwest"
"2260","15-1231","Computer Network Support Specialists","1638",1701,63,0.0385,6,31,88,125,"28.9",NA,"Southwest"
"2261","15-1232","Computer User Support Specialists","4738",5111,373,0.0787,37,92,261,390,"23.07",NA,"Southwest"
"2262","15-1241","Computer Network Architects","995",992,-3,-0.003,0,14,45,59,"50.53",NA,"Southwest"
"2263","15-1244","Network and Computer Systems Administrators","2823",2908,85,0.0301,8,48,135,191,"38.42",NA,"Southwest"
"2264","15-1245","Database Administrators and Architects","914",965,51,0.0558,5,22,46,73,"47.44","^^^","Southwest"
"2265","15-1251","Computer Programmers","1574",1405,-169,-0.1074,-17,30,68,81,"37.89",NA,"Southwest"
"2266","15-1256","Software Developers and Software Quality Assurance Analysts and Testers","11386",13391,2005,0.1761,200,287,608,1095,"49.49","^^^","Southwest"
"2267","15-1257","Web Developers and Digital Interface Designers","1021",1122,101,0.0989,10,25,52,87,"49.49","^^^","Southwest"
"2268","15-1299","Computer Occupations, All Other","2110",2206,96,0.0455,10,50,106,166,"44.97",NA,"Southwest"
"2269","15-2011","Actuaries","541",643,102,0.1885,10,9,23,42,"47.88",NA,"Southwest"
"2270","15-2031","Operations Research Analysts","1144",1398,254,0.222,25,27,55,107,"44.44",NA,"Southwest"
"2271","15-2098","Data Scientists and Mathematical Science Occupations, All Other","555",692,137,0.2468,14,13,31,58,"30.03","^^^","Southwest"
"2272","17-0000","Architecture and Engineering Occupations","17539",18270,731,0.0417,73,416,826,1315,"38.119999999999997",NA,"Southwest"
"2273","17-1011","Architects, Except Landscape and Naval","591",610,19,0.0321,2,16,26,44,"37.99",NA,"Southwest"
"2274","17-1022","Surveyors","167",174,7,0.0419,1,6,8,15,"29.68",NA,"Southwest"
"2275","17-2011","Aerospace Engineers","1351",1348,-3,-0.0022,0,28,47,75,"61.62",NA,"Southwest"
"2276","17-2031","Biomedical Engineers","129",134,5,0.0388,0,3,5,8,"38.29",NA,"Southwest"
"2277","17-2041","Chemical Engineers","171",178,7,0.0409,1,3,6,10,"45.95",NA,"Southwest"
"2278","17-2051","Civil Engineers","1431",1551,120,0.0839,12,30,74,116,"37.99",NA,"Southwest"
"2279","17-2071","Electrical Engineers","1218",1293,75,0.0616,8,30,50,88,"46.05",NA,"Southwest"
"2280","17-2072","Electronics Engineers, Except Computer","703",735,32,0.0455,3,17,29,49,"48.22",NA,"Southwest"
"2281","17-2081","Environmental Engineers","172",171,-1,-0.0058,0,4,8,12,"45.95",NA,"Southwest"
"2282","17-2112","Industrial Engineers","2999",3327,328,0.1094,33,69,127,229,"45.95",NA,"Southwest"
"2283","17-2131","Materials Engineers","277",284,7,0.0253,1,6,11,18,"47.62",NA,"Southwest"
"2284","17-2141","Mechanical Engineers","2758",2865,107,0.0388,11,48,116,175,"47.54",NA,"Southwest"
"2285","17-2199","Engineers, All Other","1175",1188,13,0.0111,1,25,49,75,"47.69",NA,"Southwest"
"2286","17-3011","Architectural and Civil Drafters","572",554,-18,-0.0315,-2,17,36,51,"28.81",NA,"Southwest"
"2287","17-3012","Electrical and Electronics Drafters","181",181,0,0,0,6,12,18,"29.78",NA,"Southwest"
"2288","17-3013","Mechanical Drafters","313",293,-20,-0.0639,-2,9,19,26,"29.68",NA,"Southwest"
"2289","17-3022","Civil Engineering Technicians","314",321,7,0.0223,1,10,20,31,"28.68",NA,"Southwest"
"2290","17-3023","Electrical and Electronics Engineering Technicians","478",475,-3,-0.0063,0,14,29,43,"29.63",NA,"Southwest"
"2291","17-3026","Industrial Engineering Technicians","548",578,30,0.0547,3,17,35,55,"28.52",NA,"Southwest"
"2292","17-3027","Mechanical Engineering Technicians","411",426,15,0.0365,2,13,26,41,"28.67",NA,"Southwest"
"2293","17-3031","Surveying and Mapping Technicians","187",190,3,0.016,0,7,16,23,"22.75",NA,"Southwest"
"2294","17-3098","Calibration and Engineering Technologists and Technicians, Except Drafters, All Other","403",413,10,0.0248,1,12,25,38,"29.18","^^^","Southwest"
"2295","19-0000","Life, Physical, and Social Science Occupations","7981",8547,566,0.0709,57,170,578,805,"30.81",NA,"Southwest"
"2296","19-1012","Food Scientists and Technologists","130",136,6,0.0462,1,3,11,15,"45.47",NA,"Southwest"
"2297","19-1022","Microbiologists","201",212,11,0.0547,1,3,14,18,"22.82",NA,"Southwest"
"2298","19-1042","Medical Scientists, Except Epidemiologists","1087",1261,174,0.1601,17,16,68,101,"39.75",NA,"Southwest"
"2299","19-2031","Chemists","886",922,36,0.0406,4,13,67,84,"36.06",NA,"Southwest"
"2300","19-2041","Environmental Scientists and Specialists, Including Health","105",110,5,0.0476,0,2,8,10,"30.88",NA,"Southwest"
"2301","19-3022","Survey Researchers","101",109,8,0.0792,1,2,7,10,"30.81",NA,"Southwest"
"2302","19-3031","Clinical, Counseling, and School Psychologists","774",841,67,0.0866,7,21,32,60,"38.96","^^^","Southwest"
"2303","19-3039","Psychologists, All Other","332",354,22,0.0663,2,9,13,24,"45.78",NA,"Southwest"
"2304","19-3051","Urban and Regional Planners","129",133,4,0.031,0,2,9,11,"36.06",NA,"Southwest"
"2305","19-4031","Chemical Technicians","504",498,-6,-0.0119,-1,9,45,53,"23.31",NA,"Southwest"
"2306","19-4042","Environmental Science and Protection Technicians, Including Health","355",375,20,0.0563,2,10,34,46,"22.75",NA,"Southwest"
"2307","19-4099","Life, Physical, and Social Science Technicians, All Other","108",115,7,0.0648,1,3,10,14,"23.99",NA,"Southwest"
"2308","19-5011","Occupational Health and Safety Specialists","754",790,36,0.0477,4,21,33,58,"37.979999999999997",NA,"Southwest"
"2309","21-0000","Community and Social Service Occupations","18378",19992,1614,0.0878,161,682,1211,2054,"22.87",NA,"Southwest"
"2310","21-1012","Educational, Guidance, School, and Vocational Counselors","1683",1909,226,0.1343,23,58,106,187,"29.79",NA,"Southwest"
"2311","21-1015","Rehabilitation Counselors","520",542,22,0.0423,2,17,32,51,"18.420000000000002",NA,"Southwest"
"2312","21-1018","Substance Abuse, Behavioral Disorder, and Mental Health Counselors","1373",1677,304,0.2214,30,50,90,170,"23.03",NA,"Southwest"
"2313","21-1019","Counselors, All Other","264",268,4,0.0152,0,9,16,25,"22.42",NA,"Southwest"
"2314","21-1021","Child, Family, and School Social Workers","2046",2284,238,0.1163,24,61,137,222,"22.75",NA,"Southwest"
"2315","21-1022","Healthcare Social Workers","1340",1477,137,0.1022,14,40,89,143,"29.28",NA,"Southwest"
"2316","21-1023","Mental Health and Substance Abuse Social Workers","1058",1258,200,0.189,20,32,73,125,"18.68",NA,"Southwest"
"2317","21-1029","Social Workers, All Other","369",383,14,0.0379,1,10,24,35,"28.58",NA,"Southwest"
"2318","21-1091","Health Educators","276",307,31,0.1123,3,10,20,33,"29.94",NA,"Southwest"
"2319","21-1092","Probation Officers and Correctional Treatment Specialists","363",367,4,0.011,0,8,22,30,"29.09",NA,"Southwest"
"2320","21-1093","Social and Human Service Assistants","2206",2495,289,0.131,29,94,177,300,"17.97",NA,"Southwest"
"2321","21-1094","Community Health Workers","362",423,61,0.1685,6,13,27,46,"18.510000000000002",NA,"Southwest"
"2322","21-2011","Clergy","5131",5182,51,0.0099,5,212,298,515,"23.47",NA,"Southwest"
"2323","23-0000","Legal Occupations","6193",6511,318,0.0513,32,170,237,439,"37.68",NA,"Southwest"
"2324","23-1011","Lawyers","3944",4144,200,0.0507,20,87,100,207,"50.28",NA,"Southwest"
"2325","23-1023","Judges, Magistrate Judges, and Magistrates","244",245,1,0.0041,0,5,6,11,"63.23",NA,"Southwest"
"2326","23-2011","Paralegals and Legal Assistants","1576",1696,120,0.0761,12,63,110,185,"22.57",NA,"Southwest"
"2327","25-0000","Education, Training, and Library Occupations","47684",53164,5480,0.1149,548,2011,2283,4842,"29.14",NA,"Southwest"
"2328","25-1032","Engineering Teachers, Postsecondary","309",322,13,0.0421,1,14,15,30,"105785","**","Southwest"
"2329","25-1042","Biological Science Teachers, Postsecondary","248",260,12,0.0484,1,11,12,24,"81896","**","Southwest"
"2330","25-1052","Chemistry Teachers, Postsecondary","113",113,0,0,0,5,5,10,"82736","**","Southwest"
"2331","25-1071","Health Specialties Teachers, Postsecondary","3377",3978,601,0.178,60,164,172,396,"167851","**","Southwest"
"2332","25-1072","Nursing Instructors and Teachers, Postsecondary","516",589,73,0.1415,7,25,26,58,"76353","**","Southwest"
"2333","25-1081","Education Teachers, Postsecondary","429",432,3,0.007,0,19,20,39,"63942","**","Southwest"
"2334","25-1122","Communications Teachers, Postsecondary","161",162,1,0.0062,0,7,8,15,"77907","**","Southwest"
"2335","25-1123","English Language and Literature Teachers, Postsecondary","359",358,-1,-0.0028,0,16,17,33,"64005","**","Southwest"
"2336","25-1124","Foreign Language and Literature Teachers, Postsecondary","176",177,1,0.0057,0,8,8,16,"63722","**","Southwest"
"2337","25-1126","Philosophy and Religion Teachers, Postsecondary","120",121,1,0.0083,0,5,6,11,"78176","**","Southwest"
"2338","25-1194","Vocational Education Teachers, Postsecondary","209",212,3,0.0144,0,9,10,19,"23.97",NA,"Southwest"
"2339","25-1199","Postsecondary Teachers, All Other","184",179,-5,-0.0272,0,8,8,16,"61590","**","Southwest"
"2340","25-2011","Preschool Teachers, Except Special Education","2009",2478,469,0.2334,47,92,131,270,"14.04",NA,"Southwest"
"2341","25-2021","Elementary School Teachers, Except Special Education","6745",7400,655,0.0971,66,217,283,566,"76063","**","Southwest"
"2342","25-2022","Middle School Teachers, Except Special and Career/Technical Education","3896",4272,376,0.0965,38,125,164,327,"61780","**","Southwest"
"2343","25-2031","Secondary School Teachers, Except Special and Career/Technical Education","7382",8147,765,0.1036,76,206,315,597,"77147","**","Southwest"
"2344","25-2032","Career/Technical Education Teachers, Secondary School","500",548,48,0.096,5,14,21,40,"76878","**","Southwest"
"2345","25-2052","Special Education Teachers, Kindergarten and Elementary School","935",1032,97,0.1037,10,32,39,81,"75978","**","Southwest"
"2346","25-2057","Special Education Teachers, Middle School","545",597,52,0.0954,5,19,23,47,"47959","**","Southwest"
"2347","25-2058","Special Education Teachers, Secondary School","1207",1373,166,0.1375,17,42,51,110,"62250","**","Southwest"
"2348","25-3021","Self-Enrichment Education Teachers","2594",3136,542,0.2089,54,171,154,379,"14.96",NA,"Southwest"
"2349","25-3031","Substitute Teachers, Short-Term","1474",1715,241,0.1635,24,95,85,204,"14.47",NA,"Southwest"
"2350","25-3097","Teachers and Instructors, All Other, Except Substitute Teachers","1277",1478,201,0.1574,20,82,74,176,"17.940000000000001","^^^","Southwest"
"2351","25-4022","Librarians and Media Collections Specialists","517",537,20,0.0387,2,26,23,51,"28.9",NA,"Southwest"
"2352","25-4031","Library Technicians","411",383,-28,-0.0681,-3,33,24,54,"14.86",NA,"Southwest"
"2353","25-9045","Teaching Assistants, Except Postsecondary","7048",7931,883,0.1253,88,335,350,773,"29118","**","Southwest"
"2354","27-0000","Arts, Design, Entertainment, Sports, and Media Occupations","14573",15873,1300,0.0892,130,594,956,1680,"23.81",NA,"Southwest"
"2355","27-1011","Art Directors","419",454,35,0.0835,4,21,23,48,"47.66",NA,"Southwest"
"2356","27-1013","Fine Artists, Including Painters, Sculptors, and Illustrators","105",129,24,0.2286,2,6,6,14,"23.77",NA,"Southwest"
"2357","27-1023","Floral Designers","117",89,-28,-0.2393,-3,3,6,6,"14.24",NA,"Southwest"
"2358","27-1024","Graphic Designers","1935",1942,7,0.0036,1,59,115,175,"24.19",NA,"Southwest"
"2359","27-1025","Interior Designers","959",940,-19,-0.0198,-2,29,56,83,"28.88",NA,"Southwest"
"2360","27-1026","Merchandise Displayers and Window Trimmers","719",751,32,0.0445,3,22,44,69,"17.37",NA,"Southwest"
"2361","27-1027","Set and Exhibit Designers","248",276,28,0.1129,3,8,16,27,"14.73",NA,"Southwest"
"2362","27-2012","Producers and Directors","333",357,24,0.0721,2,8,22,32,"30.13",NA,"Southwest"
"2363","27-2022","Coaches and Scouts","1530",1834,304,0.1987,30,96,135,261,"40423","**","Southwest"
"2364","27-2041","Music Directors and Composers","568",588,20,0.0352,2,34,32,68,"28.9",NA,"Southwest"
"2365","27-2042","Musicians and Singers","1573",1665,92,0.0585,9,95,91,195,"60.04",NA,"Southwest"
"2366","27-3011","Radio and Television Announcers","224",223,-1,-0.0045,0,9,12,21,"17.91",NA,"Southwest"
"2367","27-3023","News Analysts, Reporters, and Journalists","189",177,-12,-0.0635,-1,5,14,18,"23.62",NA,"Southwest"
"2368","27-3031","Public Relations Specialists","1435",1522,87,0.0606,9,37,97,143,"30.19",NA,"Southwest"
"2369","27-3041","Editors","499",494,-5,-0.01,0,16,31,47,"24.06",NA,"Southwest"
"2370","27-3042","Technical Writers","294",318,24,0.0816,2,8,19,29,"30.43",NA,"Southwest"
"2371","27-3043","Writers and Authors","622",662,40,0.0643,4,26,35,65,"30.07",NA,"Southwest"
"2372","27-3091","Interpreters and Translators","227",283,56,0.2467,6,10,14,30,"23.33",NA,"Southwest"
"2373","27-4011","Audio and Video Equipment Technicians","534",672,138,0.2584,14,16,44,74,"19.350000000000001",NA,"Southwest"
"2374","27-4012","Broadcast Technicians","146",160,14,0.0959,1,4,11,16,"18.64",NA,"Southwest"
"2375","27-4021","Photographers","428",557,129,0.3014,13,17,28,58,"18.3",NA,"Southwest"
"2376","29-0000","Healthcare Practitioners and Technical Occupations","57346",62522,5176,0.0903,518,1540,1797,3855,"30.1",NA,"Southwest"
"2377","29-1011","Chiropractors","202",206,4,0.0198,0,3,2,5,"38.24",NA,"Southwest"
"2378","29-1021","Dentists, General","575",599,24,0.0417,2,11,5,18,"83.89",NA,"Southwest"
"2379","29-1031","Dietitians and Nutritionists","504",541,37,0.0734,4,17,18,39,"29.66",NA,"Southwest"
"2380","29-1041","Optometrists","303",310,7,0.0231,1,5,4,10,"49.04",NA,"Southwest"
"2381","29-1051","Pharmacists","1896",1892,-4,-0.0021,0,35,36,71,"62.32",NA,"Southwest"
"2382","29-1071","Physician Assistants","541",699,158,0.2921,16,10,24,50,"48.57",NA,"Southwest"
"2383","29-1122","Occupational Therapists","873",1001,128,0.1466,13,20,31,64,"38.24",NA,"Southwest"
"2384","29-1123","Physical Therapists","1260",1439,179,0.1421,18,27,28,73,"46.09",NA,"Southwest"
"2385","29-1126","Respiratory Therapists","1049",1304,255,0.2431,26,25,30,81,"29.74",NA,"Southwest"
"2386","29-1127","Speech-Language Pathologists","989",1229,240,0.2427,24,26,40,90,"37.85",NA,"Southwest"
"2387","29-1131","Veterinarians","429",470,41,0.0956,4,7,7,18,"48.3",NA,"Southwest"
"2388","29-1141","Registered Nurses","21223",22966,1743,0.0821,174,590,556,1320,"36.08",NA,"Southwest"
"2389","29-1151","Nurse Anesthetists","417",450,33,0.0791,3,8,13,24,"80.98",NA,"Southwest"
"2390","29-1171","Nurse Practitioners","1873",2813,940,0.5019,94,49,74,217,"50.11",NA,"Southwest"
"2391","29-1181","Audiologists","181",201,20,0.1105,2,4,4,10,"29.11",NA,"Southwest"
"2392","29-1211","Anesthesiologists","112",111,-1,-0.0089,0,2,1,3,"#",NA,"Southwest"
"2393","29-1216","General Internal Medicine Physicians","220",212,-8,-0.0364,-1,4,2,5,"36.53",NA,"Southwest"
"2394","29-1218","Obstetricians and Gynecologists","193",182,-11,-0.057,-1,3,2,4,"93.76",NA,"Southwest"
"2395","29-1221","Pediatricians, General","370",343,-27,-0.073,-3,6,4,7,"63.54",NA,"Southwest"
"2396","29-1223","Psychiatrists","120",138,18,0.15,2,2,2,6,"#",NA,"Southwest"
"2397","29-1228","Physicians, All Other; and Ophthalmologists, Except Pediatric","2589",2622,33,0.0127,3,42,29,74,"37.450000000000003","^^^","Southwest"
"2398","29-1292","Dental Hygienists","1551",1664,113,0.0729,11,58,40,109,"37.33",NA,"Southwest"
"2399","29-1298","Acupuncturists and Healthcare Diagnosing or Treating Practitioners, All Other","223",220,-3,-0.0135,0,10,3,13,"37.450000000000003","^^^","Southwest"
"2400","29-2010","Clinical Laboratory Technologists and Technicians","1746",1932,186,0.1065,19,47,68,134,"23.37",NA,"Southwest"
"2401","29-2031","Cardiovascular Technologists and Technicians","269",288,19,0.0706,2,8,12,22,"29.69",NA,"Southwest"
"2402","29-2032","Diagnostic Medical Sonographers","490",582,92,0.1878,9,15,23,47,"37.53",NA,"Southwest"
"2403","29-2033","Nuclear Medicine Technologists","104",112,8,0.0769,1,3,5,9,"38.06",NA,"Southwest"
"2404","29-2034","Radiologic Technologists","1395",1505,110,0.0789,11,40,62,113,"29.64",NA,"Southwest"
"2405","29-2035","Magnetic Resonance Imaging Technologists","274",293,19,0.0693,2,8,12,22,"37.4",NA,"Southwest"
"2406","29-2040","Emergency Medical Technicians and Paramedics","1090",1129,39,0.0358,4,21,51,76,"17.760000000000002","^","Southwest"
"2407","29-2052","Pharmacy Technicians","2809",2897,88,0.0313,9,78,123,210,"17.55",NA,"Southwest"
"2408","29-2055","Surgical Technologists","463",504,41,0.0886,4,13,21,38,"22.97",NA,"Southwest"
"2409","29-2056","Veterinary Technologists and Technicians","498",535,37,0.0743,4,14,22,40,"17.73",NA,"Southwest"
"2410","29-2057","Ophthalmic Medical Technicians","253",260,7,0.0277,1,7,11,19,"17.75",NA,"Southwest"
"2411","29-2061","Licensed Practical and Licensed Vocational Nurses","5685",5924,239,0.042,24,196,242,462,"23.11",NA,"Southwest"
"2412","29-2081","Opticians, Dispensing","266",271,5,0.0188,0,11,9,20,"22.69",NA,"Southwest"
"2413","29-2098","Medical Dosimetrists, Medical Records Specialists, and Health Technologists and Technicians, All Other","2759",3010,251,0.091,25,79,124,228,"22.55","^^^","Southwest"
"2414","29-9098","Health Information Technologists, Medical Registrars, Surgical Assistants, & Healthcare Practitioners, AO","217",259,42,0.1935,4,6,10,20,"26.19","^^^","Southwest"
"2415","31-0000","Healthcare Support Occupations","31981",36145,4164,0.1302,416,1973,2133,4522,"14.32",NA,"Southwest"
"2416","31-1120","Home Health and Personal Care Aides","11216",13567,2351,0.2096,235,793,702,1730,"11.65",NA,"Southwest"
"2417","31-1131","Nursing Assistants","9571",9826,255,0.0266,26,621,549,1196,"14.5",NA,"Southwest"
"2418","31-2011","Occupational Therapy Assistants","580",740,160,0.2759,16,33,48,97,"29.9",NA,"Southwest"
"2419","31-2021","Physical Therapist Assistants","732",917,185,0.2527,18,35,62,115,"30.15",NA,"Southwest"
"2420","31-9011","Massage Therapists","847",1048,201,0.2373,20,56,50,126,"23.03",NA,"Southwest"
"2421","31-9091","Dental Assistants","1626",1739,113,0.0695,11,77,118,206,"22.87",NA,"Southwest"
"2422","31-9092","Medical Assistants","3859",4380,521,0.135,52,169,308,529,"17.989999999999998",NA,"Southwest"
"2423","31-9093","Medical Equipment Preparers","367",397,30,0.0817,3,21,25,49,"18.010000000000002",NA,"Southwest"
"2424","31-9096","Veterinary Assistants and Laboratory Animal Caretakers","935",1013,78,0.0834,8,48,108,164,"14.23",NA,"Southwest"
"2425","31-9097","Phlebotomists","995",1182,187,0.1879,19,47,79,145,"17.88",NA,"Southwest"
"2426","31-9099","Healthcare Support Workers, All Other","334",355,21,0.0629,2,19,23,44,"18.62",NA,"Southwest"
"2427","33-0000","Protective Service Occupations","16759",17892,1133,0.0676,113,852,1145,2110,"19.45",NA,"Southwest"
"2428","33-1012","First-Line Supervisors of Police and Detectives","344",348,4,0.0116,0,8,14,22,"47.53",NA,"Southwest"
"2429","33-1021","First-Line Supervisors of Fire Fighting and Prevention Workers","339",344,5,0.0147,0,8,14,22,"39.450000000000003",NA,"Southwest"
"2430","33-1090","Miscellaneous First-Line Supervisors, Protective Service Workers","586",664,78,0.1331,8,23,36,67,"25.23","^","Southwest"
"2431","33-2011","Firefighters","2997",3078,81,0.027,8,67,157,232,"24.58",NA,"Southwest"
"2432","33-3011","Bailiffs","223",215,-8,-0.0359,-1,8,12,19,"22.4",NA,"Southwest"
"2433","33-3012","Correctional Officers and Jailers","1099",987,-112,-0.1019,-11,39,56,84,"23.04",NA,"Southwest"
"2434","33-3021","Detectives and Criminal Investigators","269",271,2,0.0074,0,7,12,19,"37.19",NA,"Southwest"
"2435","33-3051","Police and Sheriff's Patrol Officers","3064",3105,41,0.0134,4,77,157,238,"36.770000000000003",NA,"Southwest"
"2436","33-9032","Security Guards","5014",5526,512,0.1021,51,279,408,738,"13.92",NA,"Southwest"
"2437","33-9091","Crossing Guards","275",317,42,0.1527,4,43,15,62,"14.01",NA,"Southwest"
"2438","33-9098","School Bus Monitors and Protective Service Workers, All Other","328",361,33,0.1006,3,47,38,88,"15.11","^^^","Southwest"
"2439","35-0000","Food Preparation and Serving Related Occupations","68281",80362,12081,0.1769,1208,5628,7575,14411,"11.22",NA,"Southwest"
"2440","35-1011","Chefs and Head Cooks","563",680,117,0.2078,12,19,61,92,"27.08",NA,"Southwest"
"2441","35-1012","First-Line Supervisors of Food Preparation and Serving Workers","5824",7120,1296,0.2225,130,289,660,1079,"15.37",NA,"Southwest"
"2442","35-2011","Cooks, Fast Food","3464",3399,-65,-0.0188,-6,202,294,490,"10.99",NA,"Southwest"
"2443","35-2012","Cooks, Institution and Cafeteria","2970",3091,121,0.0407,12,178,259,449,"14.36",NA,"Southwest"
"2444","35-2014","Cooks, Restaurant","5747",8493,2746,0.4778,275,419,609,1303,"14.17",NA,"Southwest"
"2445","35-2021","Food Preparation Workers","5303",5533,230,0.0434,23,426,498,947,"12.07",NA,"Southwest"
"2446","35-3011","Bartenders","3323",4132,809,0.2435,81,169,452,702,"10.33",NA,"Southwest"
"2447","35-3023","Fast Food and Counter Workers","21296",24748,3452,0.1621,345,2232,2434,5011,"10.77",NA,"Southwest"
"2448","35-3031","Waiters and Waitresses","11370",13528,2158,0.1898,216,914,1486,2616,"9.9499999999999993",NA,"Southwest"
"2449","35-3041","Food Servers, Nonrestaurant","1924",2002,78,0.0405,8,155,153,316,"13.33",NA,"Southwest"
"2450","35-9011","Dining Room and Cafeteria Attendants and Bartender Helpers","893",1147,254,0.2844,25,88,88,201,"10.95",NA,"Southwest"
"2451","35-9021","Dishwashers","1557",1840,283,0.1818,28,128,142,298,"11.19",NA,"Southwest"
"2452","35-9031","Hosts and Hostesses, Restaurant, Lounge, and Coffee Shop","2159",2683,524,0.2427,52,287,273,612,"10.6",NA,"Southwest"
"2453","35-9099","Food Preparation and Serving Related Workers, All Other","358",358,0,0,0,31,31,62,"11.05",NA,"Southwest"
"2454","37-0000","Building and Grounds Cleaning and Maintenance Occupations","25676",26115,439,0.0171,44,1460,1899,3403,"14.32",NA,"Southwest"
"2455","37-1011","First-Line Supervisors of Housekeeping and Janitorial Workers","1048",1029,-19,-0.0181,-2,45,72,115,"18.72",NA,"Southwest"
"2456","37-1012","First-Line Supervisors of Landscaping, Lawn Service, and Groundskeeping Workers","824",825,1,0.0012,0,26,59,85,"22.42",NA,"Southwest"
"2457","37-2011","Janitors and Cleaners, Except Maids and Housekeeping Cleaners","11466",11587,121,0.0106,12,719,808,1539,"14.16",NA,"Southwest"
"2458","37-2012","Maids and Housekeeping Cleaners","5466",5592,126,0.0231,13,376,356,745,"12.64",NA,"Southwest"
"2459","37-3011","Landscaping and Groundskeeping Workers","6532",6730,198,0.0303,20,285,568,873,"14.62",NA,"Southwest"
"2460","39-0000","Personal Care and Service Occupations","24517",28575,4058,0.1655,406,1656,2059,4121,"11.7",NA,"Southwest"
"2461","39-2021","Nonfarm Animal Caretakers","1989",2677,688,0.3459,69,150,194,413,"10.91",NA,"Southwest"
"2462","39-3031","Ushers, Lobby Attendants, and Ticket Takers","432",692,260,0.6019,26,71,57,154,"10.52",NA,"Southwest"
"2463","39-3091","Amusement and Recreation Attendants","1720",2242,522,0.3035,52,193,222,467,"10.52",NA,"Southwest"
"2464","39-5012","Hairdressers, Hairstylists, and Cosmetologists","4246",4748,502,0.1182,50,238,250,538,"14.47",NA,"Southwest"
"2465","39-5092","Manicurists and Pedicurists","904",1118,214,0.2367,21,51,54,126,"10.99",NA,"Southwest"
"2466","39-5094","Skincare Specialists","253",305,52,0.2055,5,14,15,34,"17.96",NA,"Southwest"
"2467","39-6012","Concierges","158",180,22,0.1392,2,9,13,24,"13.93",NA,"Southwest"
"2468","39-7010","Tour and Travel Guides","209",252,43,0.2057,4,15,22,41,"11.66",NA,"Southwest"
"2469","39-9011","Childcare Workers","5949",6203,254,0.0427,25,409,424,858,"11.6",NA,"Southwest"
"2470","39-9031","Fitness Trainers and Aerobics Instructors","1797",2416,619,0.3445,62,123,200,385,"14.34",NA,"Southwest"
"2471","39-9032","Recreation Workers","2678",2833,155,0.0579,16,161,262,439,"11.7",NA,"Southwest"
"2472","41-0000","Sales and Related Occupations","77963",76977,-986,-0.0126,-99,3767,6027,9695,"14.5",NA,"Southwest"
"2473","41-1011","First-Line Supervisors of Retail Sales Workers","5809",5461,-348,-0.0599,-35,199,390,554,"18.59",NA,"Southwest"
"2474","41-1012","First-Line Supervisors of Non-Retail Sales Workers","2223",2079,-144,-0.0648,-14,62,128,176,"39.130000000000003",NA,"Southwest"
"2475","41-2011","Cashiers","14843",13171,-1672,-0.1126,-167,1192,1341,2366,"11.04",NA,"Southwest"
"2476","41-2021","Counter and Rental Clerks","1737",1902,165,0.095,16,82,125,223,"14.32",NA,"Southwest"
"2477","41-2031","Retail Salespersons","20684",20403,-281,-0.0136,-28,1149,1697,2818,"12.86",NA,"Southwest"
"2478","41-3011","Advertising Sales Agents","670",640,-30,-0.0448,-3,20,61,78,"23.14",NA,"Southwest"
"2479","41-3021","Insurance Sales Agents","2708",2836,128,0.0473,13,92,155,260,"28.96",NA,"Southwest"
"2480","41-3031","Securities, Commodities, and Financial Services Sales Agents","2676",2871,195,0.0729,20,61,175,256,"29.7",NA,"Southwest"
"2481","41-3041","Travel Agents","188",185,-3,-0.016,0,9,12,21,"18.45",NA,"Southwest"
"2482","41-3091","Sales Representatives of Services, Except Advertising, Insurance, Financial Services, and Travel","6622",7034,412,0.0622,41,172,600,813,"29.34",NA,"Southwest"
"2483","41-4011","Sales Representatives, Wholesale and Manufacturing, Technical and Scientific Products","1974",2052,78,0.0395,8,60,136,204,"47.73",NA,"Southwest"
"2484","41-4012","Sales Representatives, Wholesale and Manufacturing, Except Technical and Scientific Products","11207",11706,499,0.0445,50,339,774,1163,"30.1",NA,"Southwest"
"2485","41-9011","Demonstrators and Product Promoters","723",697,-26,-0.036,-3,79,47,123,"14.57",NA,"Southwest"
"2486","41-9022","Real Estate Sales Agents","2242",2351,109,0.0486,11,96,101,208,"18.39",NA,"Southwest"
"2487","41-9031","Sales Engineers","616",651,35,0.0568,4,13,52,69,"50.8",NA,"Southwest"
"2488","41-9041","Telemarketers","533",432,-101,-0.1895,-10,22,49,61,"17.23",NA,"Southwest"
"2489","41-9099","Sales and Related Workers, All Other","516",523,7,0.0136,1,24,43,68,"13.93",NA,"Southwest"
"2490","43-0000","Office and Administrative Support Occupations","117188",112624,-4564,-0.0389,-456,5451,7178,12173,"18.170000000000002",NA,"Southwest"
"2491","43-1011","First-Line Supervisors of Office and Administrative Support Workers","8092",7835,-257,-0.0318,-26,296,487,757,"29.1",NA,"Southwest"
"2492","43-2011","Switchboard Operators, Including Answering Service","387",282,-105,-0.2713,-10,17,20,27,"14.26",NA,"Southwest"
"2493","43-3011","Bill and Account Collectors","1194",1045,-149,-0.1248,-15,41,79,105,"18.100000000000001",NA,"Southwest"
"2494","43-3021","Billing and Posting Clerks","3195",3188,-7,-0.0022,-1,131,196,326,"18.13",NA,"Southwest"
"2495","43-3031","Bookkeeping, Accounting, and Auditing Clerks","10215",9727,-488,-0.0478,-49,584,509,1044,"18.96",NA,"Southwest"
"2496","43-3051","Payroll and Timekeeping Clerks","546",476,-70,-0.1282,-7,24,28,45,"23.12",NA,"Southwest"
"2497","43-3061","Procurement Clerks","459",465,6,0.0131,1,13,29,43,"18.989999999999998",NA,"Southwest"
"2498","43-3071","Tellers","2209",1952,-257,-0.1163,-26,84,131,189,"14.58",NA,"Southwest"
"2499","43-4011","Brokerage Clerks","410",389,-21,-0.0512,-2,16,26,40,"23.17",NA,"Southwest"
"2500","43-4031","Court, Municipal, and License Clerks","1233",1258,25,0.0203,2,61,63,126,"22.4",NA,"Southwest"
"2501","43-4041","Credit Authorizers, Checkers, and Clerks","101",94,-7,-0.0693,-1,4,6,9,"23.1",NA,"Southwest"
"2502","43-4051","Customer Service Representatives","21246",20477,-769,-0.0362,-77,981,1640,2544,"18.010000000000002",NA,"Southwest"
"2503","43-4061","Eligibility Interviewers, Government Programs","519",528,9,0.0173,1,19,27,47,"22.4",NA,"Southwest"
"2504","43-4071","File Clerks","460",398,-62,-0.1348,-6,23,26,43,"17.829999999999998",NA,"Southwest"
"2505","43-4081","Hotel, Motel, and Resort Desk Clerks","547",623,76,0.1389,8,34,62,104,"11.37",NA,"Southwest"
"2506","43-4111","Interviewers, Except Eligibility and Loan","1366",1252,-114,-0.0835,-11,76,84,149,"17.84",NA,"Southwest"
"2507","43-4121","Library Assistants, Clerical","821",756,-65,-0.0792,-6,70,50,114,"13.99",NA,"Southwest"
"2508","43-4131","Loan Interviewers and Clerks","1195",1148,-47,-0.0393,-5,34,69,98,"22.42",NA,"Southwest"
"2509","43-4141","New Accounts Clerks","100",89,-11,-0.11,-1,3,6,8,"22.04",NA,"Southwest"
"2510","43-4151","Order Clerks","1112",940,-172,-0.1547,-17,44,64,91,"22.04",NA,"Southwest"
"2511","43-4161","Human Resources Assistants, Except Payroll and Timekeeping","563",550,-13,-0.0231,-1,21,34,54,"18.48",NA,"Southwest"
"2512","43-4171","Receptionists and Information Clerks","6263",6422,159,0.0254,16,354,438,808,"14.26",NA,"Southwest"
"2513","43-4199","Information and Record Clerks, All Other","510",537,27,0.0529,3,21,34,58,"22.11",NA,"Southwest"
"2514","43-5021","Couriers and Messengers","577",563,-14,-0.0243,-1,23,31,53,"14.72",NA,"Southwest"
"2515","43-5031","Police, Fire, and Ambulance Dispatchers","457",466,9,0.0197,1,16,26,43,"23.01",NA,"Southwest"
"2516","43-5032","Dispatchers, Except Police, Fire, and Ambulance","1055",1078,23,0.0218,2,38,60,100,"18.73",NA,"Southwest"
"2517","43-5051","Postal Service Clerks","358",327,-31,-0.0866,-3,16,12,25,"24.64",NA,"Southwest"
"2518","43-5052","Postal Service Mail Carriers","1588",1447,-141,-0.0888,-14,53,54,93,"27.55",NA,"Southwest"
"2519","43-5053","Postal Service Mail Sorters, Processors, and Processing Machine Operators","1047",907,-140,-0.1337,-14,53,32,71,"22.73",NA,"Southwest"
"2520","43-5061","Production, Planning, and Expediting Clerks","3274",3455,181,0.0553,18,120,218,356,"22.96",NA,"Southwest"
"2521","43-5071","Shipping, Receiving, and Traffic Clerks","6018",5766,-252,-0.0419,-25,215,346,536,"17.829999999999998",NA,"Southwest"
"2522","43-5111","Weighers, Measurers, Checkers, and Samplers, Recordkeeping","160",174,14,0.0875,1,6,10,17,"18.13",NA,"Southwest"
"2523","43-6011","Executive Secretaries and Executive Administrative Assistants","2126",1675,-451,-0.2121,-45,97,106,158,"29.42",NA,"Southwest"
"2524","43-6012","Legal Secretaries","462",349,-113,-0.2446,-11,21,23,33,"18.260000000000002",NA,"Southwest"
"2525","43-6013","Medical Secretaries","4607",4951,344,0.0747,34,243,267,544,"17.829999999999998",NA,"Southwest"
"2526","43-6014","Secretaries and Administrative Assistants, Except Legal, Medical, and Executive","8513",7713,-800,-0.094,-80,413,453,786,"18.18",NA,"Southwest"
"2527","43-9021","Data Entry Keyers","1133",860,-273,-0.241,-27,44,63,80,"17.84",NA,"Southwest"
"2528","43-9022","Word Processors and Typists","229",148,-81,-0.3537,-8,11,10,13,"22.78",NA,"Southwest"
"2529","43-9041","Insurance Claims and Policy Processing Clerks","2037",1985,-52,-0.0255,-5,71,118,184,"22.87",NA,"Southwest"
"2530","43-9051","Mail Clerks and Mail Machine Operators, Except Postal Service","650",585,-65,-0.1,-6,31,39,64,"14.33",NA,"Southwest"
"2531","43-9061","Office Clerks, General","16314",15738,-576,-0.0353,-58,874,950,1766,"18.12",NA,"Southwest"
"2532","43-9071","Office Machine Operators, Except Computer","559",491,-68,-0.1216,-7,27,32,52,"17.899999999999999",NA,"Southwest"
"2533","43-9199","Office and Administrative Support Workers, All Other","657",683,26,0.0396,3,28,46,77,"22.04",NA,"Southwest"
"2534","45-0000","Farming, Fishing, and Forestry Occupations","1160",1176,16,0.0138,2,48,132,182,"14.98",NA,"Southwest"
"2535","47-0000","Construction and Extraction Occupations","34160",35880,1720,0.0504,172,1029,2375,3576,"24",NA,"Southwest"
"2536","47-1011","First-Line Supervisors of Construction Trades and Extraction Workers","2972",3156,184,0.0619,18,87,198,303,"31.06",NA,"Southwest"
"2537","47-2021","Brickmasons and Blockmasons","869",836,-33,-0.038,-3,27,52,76,"29.77",NA,"Southwest"
"2538","47-2031","Carpenters","5564",5641,77,0.0138,8,164,350,522,"23.35",NA,"Southwest"
"2539","47-2051","Cement Masons and Concrete Finishers","838",844,6,0.0072,1,20,55,76,"23.29",NA,"Southwest"
"2540","47-2061","Construction Laborers","6875",7413,538,0.0783,54,211,482,747,"22.55",NA,"Southwest"
"2541","47-2073","Operating Engineers and Other Construction Equipment Operators","1802",1894,92,0.0511,9,60,132,201,"29.34",NA,"Southwest"
"2542","47-2081","Drywall and Ceiling Tile Installers","215",225,10,0.0465,1,6,12,19,"23.35",NA,"Southwest"
"2543","47-2111","Electricians","4000",4362,362,0.0905,36,121,307,464,"28.69",NA,"Southwest"
"2544","47-2121","Glaziers","277",301,24,0.0866,2,8,22,32,"29.27",NA,"Southwest"
"2545","47-2131","Insulation Workers, Floor, Ceiling, and Wall","302",325,23,0.0762,2,7,21,30,"23.31",NA,"Southwest"
"2546","47-2132","Insulation Workers, Mechanical","114",120,6,0.0526,1,3,8,12,"29.44",NA,"Southwest"
"2547","47-2141","Painters, Construction and Maintenance","1372",1435,63,0.0459,6,42,78,126,"22.62",NA,"Southwest"
"2548","47-2152","Plumbers, Pipefitters, and Steamfitters","2826",2982,156,0.0552,16,85,209,310,"30.08",NA,"Southwest"
"2549","47-2181","Roofers","884",957,73,0.0826,7,23,64,94,"23.44",NA,"Southwest"
"2550","47-2211","Sheet Metal Workers","972",983,11,0.0113,1,27,63,91,"28.29",NA,"Southwest"
"2551","47-2221","Structural Iron and Steel Workers","489",530,41,0.0838,4,13,39,56,"30.12",NA,"Southwest"
"2552","47-3011","Helpers--Brickmasons, Blockmasons, Stonemasons, and Tile and Marble Setters","132",124,-8,-0.0606,-1,4,11,14,"18.97",NA,"Southwest"
"2553","47-3015","Helpers--Pipelayers, Plumbers, Pipefitters, and Steamfitters","183",193,10,0.0546,1,6,16,23,"17.87",NA,"Southwest"
"2554","47-4011","Construction and Building Inspectors","359",318,-41,-0.1142,-4,18,20,34,"29.63",NA,"Southwest"
"2555","47-4021","Elevator Installers and Repairers","159",168,9,0.0566,1,4,11,16,"47.24",NA,"Southwest"
"2556","47-4051","Highway Maintenance Workers","594",601,7,0.0118,1,23,38,62,"22.66",NA,"Southwest"
"2557","47-4071","Septic Tank Servicers and Sewer Pipe Cleaners","252",273,21,0.0833,2,8,22,32,"22.66",NA,"Southwest"
"2558","47-4090","Miscellaneous Construction and Related Workers","113",125,12,0.1062,1,4,10,15,"22.31",NA,"Southwest"
"2559","49-0000","Installation, Maintenance, and Repair Occupations","30825",32798,1973,0.064,197,998,2012,3207,"23.17",NA,"Southwest"
"2560","49-1011","First-Line Supervisors of Mechanics, Installers, and Repairers","2286",2384,98,0.0429,10,68,139,217,"31.79",NA,"Southwest"
"2561","49-2011","Computer, Automated Teller, and Office Machine Repairers","353",333,-20,-0.0567,-2,10,26,34,"22.28",NA,"Southwest"
"2562","49-2022","Telecommunications Equipment Installers and Repairers, Except Line Installers","824",857,33,0.04,3,29,64,96,"29.43",NA,"Southwest"
"2563","49-2094","Electrical and Electronics Repairers, Commercial and Industrial Equipment","173",179,6,0.0347,1,5,9,15,"28.53",NA,"Southwest"
"2564","49-2098","Security and Fire Alarm Systems Installers","558",625,67,0.1201,7,14,45,66,"23.31",NA,"Southwest"
"2565","49-3021","Automotive Body and Related Repairers","519",548,29,0.0559,3,17,32,52,"22.31",NA,"Southwest"
"2566","49-3023","Automotive Service Technicians and Mechanics","3806",3799,-7,-0.0018,-1,113,258,370,"22.5",NA,"Southwest"
"2567","49-3031","Bus and Truck Mechanics and Diesel Engine Specialists","1036",1094,58,0.056,6,30,66,102,"23.34",NA,"Southwest"
"2568","49-3042","Mobile Heavy Equipment Mechanics, Except Engines","544",580,36,0.0662,4,17,38,59,"27.79",NA,"Southwest"
"2569","49-9011","Mechanical Door Repairers","149",157,8,0.0537,1,4,9,14,"19.260000000000002",NA,"Southwest"
"2570","49-9012","Control and Valve Installers and Repairers, Except Mechanical Door","100",103,3,0.03,0,2,6,8,"31.9",NA,"Southwest"
"2571","49-9021","Heating, Air Conditioning, and Refrigeration Mechanics and Installers","1864",1976,112,0.0601,11,49,131,191,"23.9",NA,"Southwest"
"2572","49-9041","Industrial Machinery Mechanics","3202",3823,621,0.1939,62,108,190,360,"28.9",NA,"Southwest"
"2573","49-9043","Maintenance Workers, Machinery","378",426,48,0.127,5,13,22,40,"29.81",NA,"Southwest"
"2574","49-9044","Millwrights","271",306,35,0.1292,4,8,16,28,"32.590000000000003",NA,"Southwest"
"2575","49-9051","Electrical Power-Line Installers and Repairers","504",508,4,0.0079,0,10,34,44,"38.58",NA,"Southwest"
"2576","49-9052","Telecommunications Line Installers and Repairers","1434",1522,88,0.0614,9,33,125,167,"23.04",NA,"Southwest"
"2577","49-9062","Medical Equipment Repairers","372",392,20,0.0538,2,17,23,42,"28.95",NA,"Southwest"
"2578","49-9071","Maintenance and Repair Workers, General","8593",9189,596,0.0694,60,313,519,892,"22.45",NA,"Southwest"
"2579","49-9091","Coin, Vending, and Amusement Machine Servicers and Repairers","143",158,15,0.1049,2,7,11,20,"18.09",NA,"Southwest"
"2580","49-9098","Helpers--Installation, Maintenance, and Repair Workers","236",247,11,0.0466,1,10,20,31,"17.63",NA,"Southwest"
"2581","49-9099","Installation, Maintenance, and Repair Workers, All Other","1348",1422,74,0.0549,7,49,92,148,"18.39",NA,"Southwest"
"2582","51-0000","Production Occupations","65486",64664,-822,-0.0126,-82,2441,4631,6990,"18.29",NA,"Southwest"
"2583","51-1011","First-Line Supervisors of Production and Operating Workers","4347",4459,112,0.0258,11,132,296,439,"30.03",NA,"Southwest"
"2584","51-2028","Electrical, Electronic, and Electromechanical Assemblers, Except Coil Winders, Tapers, and Finishers","1747",1824,77,0.0441,8,72,114,194,"17.52",NA,"Southwest"
"2585","51-2041","Structural Metal Fabricators and Fitters","180",154,-26,-0.1444,-3,4,13,14,"21.99",NA,"Southwest"
"2586","51-2051","Fiberglass Laminators and Fabricators","137",140,3,0.0219,0,5,10,15,"18.149999999999999",NA,"Southwest"
"2587","51-2090","Miscellaneous Assemblers and Fabricators","7914",7394,-520,-0.0657,-52,292,546,786,"15.09",NA,"Southwest"
"2588","51-3011","Bakers","963",1068,105,0.109,10,57,76,143,"14.22",NA,"Southwest"
"2589","51-3021","Butchers and Meat Cutters","743",685,-58,-0.0781,-6,29,53,76,"14.45",NA,"Southwest"
"2590","51-3092","Food Batchmakers","1191",1219,28,0.0235,3,56,90,149,"17.48",NA,"Southwest"
"2591","51-4021","Extruding and Drawing Machine Setters, Operators, and Tenders, Metal and Plastic","515",507,-8,-0.0155,-1,18,32,49,"18.399999999999999",NA,"Southwest"
"2592","51-4031","Cutting, Punching, and Press Machine Setters, Operators, and Tenders, Metal and Plastic","1779",1795,16,0.009,2,57,123,182,"18.29",NA,"Southwest"
"2593","51-4033","Grinding, Lapping, Polishing, and Buffing Machine Tool Setters, Operators, and Tenders, Metal and Plastic","715",674,-41,-0.0573,-4,31,48,75,"18.27",NA,"Southwest"
"2594","51-4034","Lathe and Turning Machine Tool Setters, Operators, and Tenders, Metal and Plastic","247",241,-6,-0.0243,-1,8,16,23,"22.91",NA,"Southwest"
"2595","51-4041","Machinists","4214",4444,230,0.0546,23,145,294,462,"23.04",NA,"Southwest"
"2596","51-4051","Metal-Refining Furnace Operators and Tenders","108",112,4,0.037,0,2,8,10,"22.04",NA,"Southwest"
"2597","51-4072","Molding, Coremaking, and Casting Machine Setters, Operators, and Tenders, Metal and Plastic","1178",1149,-29,-0.0246,-3,38,79,114,"17.5",NA,"Southwest"
"2598","51-4081","Multiple Machine Tool Setters, Operators, and Tenders, Metal and Plastic","2182",2362,180,0.0825,18,74,154,246,"18.149999999999999",NA,"Southwest"
"2599","51-4111","Tool and Die Makers","694",705,11,0.0159,1,26,44,71,"24.61",NA,"Southwest"
"2600","51-4121","Welders, Cutters, Solderers, and Brazers","2500",2679,179,0.0716,18,68,204,290,"22.32",NA,"Southwest"
"2601","51-4122","Welding, Soldering, and Brazing Machine Setters, Operators, and Tenders","169",160,-9,-0.0533,-1,4,13,16,"18.29",NA,"Southwest"
"2602","51-4191","Heat Treating Equipment Setters, Operators, and Tenders, Metal and Plastic","171",169,-2,-0.0117,0,6,12,18,"23.05",NA,"Southwest"
"2603","51-4193","Plating and Coating Machine Setters, Operators, and Tenders, Metal and Plastic","362",334,-28,-0.0773,-3,11,24,32,"18.21",NA,"Southwest"
"2604","51-5111","Prepress Technicians and Workers","380",290,-90,-0.2368,-9,13,32,36,"22.42",NA,"Southwest"
"2605","51-5112","Printing Press Operators","1484",1369,-115,-0.0775,-12,52,100,140,"18.34",NA,"Southwest"
"2606","51-5113","Print Binding and Finishing Workers","434",333,-101,-0.2327,-10,19,24,33,"18.09",NA,"Southwest"
"2607","51-6011","Laundry and Dry-Cleaning Workers","1132",1269,137,0.121,14,78,81,173,"11.56",NA,"Southwest"
"2608","51-6021","Pressers, Textile, Garment, and Related Materials","209",190,-19,-0.0909,-2,9,12,19,"13.63",NA,"Southwest"
"2609","51-6031","Sewing Machine Operators","508",565,57,0.1122,6,32,28,66,"14.19",NA,"Southwest"
"2610","51-6052","Tailors, Dressmakers, and Custom Sewers","139",126,-13,-0.0935,-1,10,7,16,"16.899999999999999",NA,"Southwest"
"2611","51-7011","Cabinetmakers and Bench Carpenters","350",335,-15,-0.0429,-2,13,19,30,"18.7",NA,"Southwest"
"2612","51-7021","Furniture Finishers","118",110,-8,-0.0678,-1,7,8,14,"18.45",NA,"Southwest"
"2613","51-7042","Woodworking Machine Setters, Operators, and Tenders, Except Sawing","338",346,8,0.0237,1,10,25,36,"18.09",NA,"Southwest"
"2614","51-8021","Stationary Engineers and Boiler Operators","141",144,3,0.0213,0,7,10,17,"36.82",NA,"Southwest"
"2615","51-8031","Water and Wastewater Treatment Plant and System Operators","550",503,-47,-0.0855,-5,15,33,43,"28.5",NA,"Southwest"
"2616","51-8091","Chemical Plant and System Operators","232",211,-21,-0.0905,-2,5,17,20,"39.03",NA,"Southwest"
"2617","51-9011","Chemical Equipment Operators and Tenders","996",850,-146,-0.1466,-15,20,72,77,"23.74",NA,"Southwest"
"2618","51-9012","Separating, Filtering, Clarifying, Precipitating, and Still Machine Setters, Operators, and Tenders","322",320,-2,-0.0062,0,7,25,32,"36.43",NA,"Southwest"
"2619","51-9022","Grinding and Polishing Workers, Hand","141",114,-27,-0.1915,-3,4,10,11,"22.91",NA,"Southwest"
"2620","51-9023","Mixing and Blending Machine Setters, Operators, and Tenders","1225",1214,-11,-0.009,-1,41,91,131,"18.350000000000001",NA,"Southwest"
"2621","51-9032","Cutting and Slicing Machine Setters, Operators, and Tenders","277",267,-10,-0.0361,-1,12,21,32,"19.47",NA,"Southwest"
"2622","51-9041","Extruding, Forming, Pressing, and Compacting Machine Setters, Operators, and Tenders","424",444,20,0.0472,2,12,32,46,"18.7",NA,"Southwest"
"2623","51-9051","Furnace, Kiln, Oven, Drier, and Kettle Operators and Tenders","185",194,9,0.0486,1,6,12,19,"18.27",NA,"Southwest"
"2624","51-9061","Inspectors, Testers, Sorters, Samplers, and Weighers","4936",4396,-540,-0.1094,-54,179,370,495,"20.36",NA,"Southwest"
"2625","51-9111","Packaging and Filling Machine Operators and Tenders","5290",5539,249,0.0471,25,223,359,607,"18.100000000000001",NA,"Southwest"
"2626","51-9124","Coating, Painting, and Spraying Machine Setters, Operators, and Tenders","788",812,24,0.0305,2,22,57,81,"18.32",NA,"Southwest"
"2627","51-9161","Computer Numerically Controlled Tool Operators","1945",1817,-128,-0.0658,-13,64,139,190,"22.42",NA,"Southwest"
"2628","51-9162","Computer Numerically Controlled Tool Programmers","224",277,53,0.2366,5,9,18,32,"29.84",NA,"Southwest"
"2629","51-9191","Adhesive Bonding Machine Operators and Tenders","291",294,3,0.0103,0,16,20,36,"18.36",NA,"Southwest"
"2630","51-9192","Cleaning, Washing, and Metal Pickling Equipment Operators and Tenders","107",111,4,0.0374,0,4,8,12,"18.18",NA,"Southwest"
"2631","51-9195","Molders, Shapers, and Casters, Except Metal and Plastic","257",293,36,0.1401,4,10,18,32,"18.13",NA,"Southwest"
"2632","51-9196","Paper Goods Machine Setters, Operators, and Tenders","1154",1160,6,0.0052,1,52,77,130,"18.510000000000002",NA,"Southwest"
"2633","51-9198","Helpers--Production Workers","1619",1482,-137,-0.0846,-14,73,146,205,"17.75",NA,"Southwest"
"2634","51-9199","Production Workers, All Other","1248",1303,55,0.0441,6,44,94,144,"18.63",NA,"Southwest"
"2635","53-0000","Transportation and Material Moving Occupations","74004",81019,7015,0.0948,702,3595,6143,10440,"17.55",NA,"Southwest"
"2636","53-2012","Commercial Pilots","159",167,8,0.0503,1,6,12,19,"128784","**","Southwest"
"2637","53-3031","Driver/Sales Workers","6293",7747,1454,0.2311,145,288,476,909,"14.19",NA,"Southwest"
"2638","53-3032","Heavy and Tractor-Trailer Truck Drivers","9383",9901,518,0.0552,52,395,654,1101,"23.52",NA,"Southwest"
"2639","53-3033","Light Truck or Delivery Services Drivers","5583",6237,654,0.1171,65,242,401,708,"18.27",NA,"Southwest"
"2640","53-3058","Passenger Vehicle Drivers, Except Bus Drivers, Transit and Intercity","3507",4226,719,0.205,72,255,192,519,"18.05","^^^","Southwest"
"2641","53-6021","Parking Lot Attendants","373",413,40,0.1072,4,19,41,64,"11.26",NA,"Southwest"
"2642","53-6031","Automotive and Watercraft Service Attendants","748",792,44,0.0588,4,36,68,108,"14.32",NA,"Southwest"
"2643","53-7021","Crane and Tower Operators","112",120,8,0.0714,1,3,9,13,"24.05",NA,"Southwest"
"2644","53-7051","Industrial Truck and Tractor Operators","5722",6284,562,0.0982,56,181,461,698,"18.45",NA,"Southwest"
"2645","53-7061","Cleaners of Vehicles and Equipment","1893",2035,142,0.075,14,96,175,285,"14.22",NA,"Southwest"
"2646","53-7062","Laborers and Freight, Stock, and Material Movers, Hand","14989",16517,1528,0.1019,153,689,1371,2213,"14.85",NA,"Southwest"
"2647","53-7064","Packers and Packagers, Hand","4470",4671,201,0.045,20,260,370,650,"14.42",NA,"Southwest"
"2648","53-7065","Stockers and Order Fillers","14601",15344,743,0.0509,74,852,1460,2386,"14.34",NA,"Southwest"
"2649","53-7081","Refuse and Recyclable Material Collectors","1087",1207,120,0.1104,12,49,103,164,"18.940000000000001",NA,"Southwest"
